COUNTY_ID,COUNTY,TOWN_ID,TOWN,V_ID,VILLAGE,A0A14_CNT,A0A14_M_CNT,A0A14_F_CNT,A15A64_CNT,A15A64_M_CNT,A15A64_F_CNT,A65UP_CNT,A65UP_M_CNT,A65UP_F_CNT,INFO_TIME
"64000",高雄市,"64000010",鹽埕區,64000010-001,藍橋里,"95","41","54","966","468","498","324","146","178",113Y06M
"64000",高雄市,"64000010",鹽埕區,64000010-002,慈愛里,"27","15","12","210","113","97","109","45","64",113Y06M
"64000",高雄市,"64000010",鹽埕區,64000010-003,博愛里,"34","15","19","412","212","200","184","74","110",113Y06M
"64000",高雄市,"64000010",鹽埕區,64000010-004,壽星里,"87","48","39","837","438","399","402","186","216",113Y06M
"64000",高雄市,"64000010",鹽埕區,64000010-005,中山里,"116","50","66","960","471","489","339","152","187",113Y06M
"64000",高雄市,"64000010",鹽埕區,64000010-006,教仁里,"136","63","73","1294","622","672","596","271","325",113Y06M
"64000",高雄市,"64000010",鹽埕區,64000010-007,新樂里,"57","29","28","527","269","258","262","123","139",113Y06M
"64000",高雄市,"64000010",鹽埕區,64000010-008,中原里,"44","24","20","366","170","196","175","84","91",113Y06M
"64000",高雄市,"64000010",鹽埕區,64000010-009,光明里,"83","44","39","971","493","478","468","237","231",113Y06M
"64000",高雄市,"64000010",鹽埕區,64000010-010,育仁里,"90","45","45","536","260","276","238","104","134",113Y06M
"64000",高雄市,"64000010",鹽埕區,64000010-011,河濱里,"115","54","61","1044","512","532","472","214","258",113Y06M
"64000",高雄市,"64000010",鹽埕區,64000010-012,沙地里,"51","30","21","459","217","242","188","84","104",113Y06M
"64000",高雄市,"64000010",鹽埕區,64000010-013,南端里,"71","33","38","600","308","292","297","132","165",113Y06M
"64000",高雄市,"64000010",鹽埕區,64000010-014,港都里,"83","42","41","687","324","363","320","165","155",113Y06M
"64000",高雄市,"64000010",鹽埕區,64000010-015,江西里,"79","43","36","702","374","328","296","138","158",113Y06M
"64000",高雄市,"64000010",鹽埕區,64000010-016,新豐里,"90","40","50","623","318","305","196","86","110",113Y06M
"64000",高雄市,"64000010",鹽埕區,64000010-017,府北里,"165","83","82","1467","731","736","561","275","286",113Y06M
"64000",高雄市,"64000010",鹽埕區,64000010-018,陸橋里,"74","40","34","730","362","368","328","148","180",113Y06M
"64000",高雄市,"64000010",鹽埕區,64000010-019,瀨南里,"24","15","9","362","190","172","186","87","99",113Y06M
"64000",高雄市,"64000010",鹽埕區,64000010-020,新化里,"50","29","21","392","224","168","150","63","87",113Y06M
"64000",高雄市,"64000010",鹽埕區,64000010-021,江南里,"50","25","25","407","210","197","140","60","80",113Y06M
"64000",高雄市,"64000020",鼓山區,64000020-001,鼓峰里,"121","65","56","1367","657","710","500","208","292",113Y06M
"64000",高雄市,"64000020",鼓山區,64000020-002,雄峰里,"112","65","47","1349","669","680","566","229","337",113Y06M
"64000",高雄市,"64000020",鼓山區,64000020-003,前峰里,"278","145","133","2838","1451","1387","1146","493","653",113Y06M
"64000",高雄市,"64000020",鼓山區,64000020-004,光榮里,"293","162","131","2517","1327","1190","931","425","506",113Y06M
"64000",高雄市,"64000020",鼓山區,64000020-005,民族里,"90","47","43","925","489","436","351","150","201",113Y06M
"64000",高雄市,"64000020",鼓山區,64000020-006,內惟里,"71","35","36","767","410","357","267","129","138",113Y06M
"64000",高雄市,"64000020",鼓山區,64000020-007,建國里,"205","126","79","1819","944","875","587","262","325",113Y06M
"64000",高雄市,"64000020",鼓山區,64000020-008,忠正里,"299","147","152","2641","1290","1351","956","404","552",113Y06M
"64000",高雄市,"64000020",鼓山區,64000020-009,自強里,"24","14","10","382","206","176","277","129","148",113Y06M
"64000",高雄市,"64000020",鼓山區,64000020-010,龍井里,"73","42","31","835","435","400","337","152","185",113Y06M
"64000",高雄市,"64000020",鼓山區,64000020-011,正德里,"161","91","70","1521","789","732","446","194","252",113Y06M
"64000",高雄市,"64000020",鼓山區,64000020-012,平和里,"301","139","162","2497","1252","1245","871","370","501",113Y06M
"64000",高雄市,"64000020",鼓山區,64000020-013,民強里,"188","102","86","1777","909","868","690","305","385",113Y06M
"64000",高雄市,"64000020",鼓山區,64000020-014,厚生里,"271","139","132","2348","1204","1144","624","277","347",113Y06M
"64000",高雄市,"64000020",鼓山區,64000020-015,龍子里,"4304","2226","2078","13924","6206","7718","2771","1198","1573",113Y06M
"64000",高雄市,"64000020",鼓山區,64000020-016,龍水里,"7725","3926","3799","22781","9978","12803","3889","1672","2217",113Y06M
"64000",高雄市,"64000020",鼓山區,64000020-017,明誠里,"3496","1884","1612","14056","6286","7770","3000","1304","1696",113Y06M
"64000",高雄市,"64000020",鼓山區,64000020-018,華豐里,"278","161","117","2905","1413","1492","927","392","535",113Y06M
"64000",高雄市,"64000020",鼓山區,64000020-019,裕興里,"288","143","145","2437","1247","1190","778","334","444",113Y06M
"64000",高雄市,"64000020",鼓山區,64000020-020,裕豐里,"178","94","84","1741","867","874","686","300","386",113Y06M
"64000",高雄市,"64000020",鼓山區,64000020-021,鼓岩里,"53","27","26","723","384","339","386","154","232",113Y06M
"64000",高雄市,"64000020",鼓山區,64000020-022,樹德里,"90","46","44","802","419","383","288","131","157",113Y06M
"64000",高雄市,"64000020",鼓山區,64000020-023,寶樹里,"55","24","31","1431","876","555","514","293","221",113Y06M
"64000",高雄市,"64000020",鼓山區,64000020-024,興宗里,"65","38","27","837","437","400","370","174","196",113Y06M
"64000",高雄市,"64000020",鼓山區,64000020-025,光化里,"64","31","33","874","454","420","341","150","191",113Y06M
"64000",高雄市,"64000020",鼓山區,64000020-026,山下里,"117","52","65","929","470","459","335","147","188",113Y06M
"64000",高雄市,"64000020",鼓山區,64000020-027,河邊里,"64","28","36","767","403","364","307","141","166",113Y06M
"64000",高雄市,"64000020",鼓山區,64000020-028,綠川里,"110","58","52","952","515","437","351","158","193",113Y06M
"64000",高雄市,"64000020",鼓山區,64000020-029,登山里,"20","11","9","400","229","171","187","95","92",113Y06M
"64000",高雄市,"64000020",鼓山區,64000020-030,峰南里,"56","38","18","521","281","240","215","88","127",113Y06M
"64000",高雄市,"64000020",鼓山區,64000020-031,麗興里,"62","26","36","629","339","290","290","123","167",113Y06M
"64000",高雄市,"64000020",鼓山區,64000020-032,新民里,"70","39","31","658","351","307","269","124","145",113Y06M
"64000",高雄市,"64000020",鼓山區,64000020-033,延平里,"42","16","26","516","272","244","183","80","103",113Y06M
"64000",高雄市,"64000020",鼓山區,64000020-034,維生里,"64","32","32","806","391","415","342","161","181",113Y06M
"64000",高雄市,"64000020",鼓山區,64000020-035,惠安里,"77","36","41","739","413","326","320","160","160",113Y06M
"64000",高雄市,"64000020",鼓山區,64000020-036,壽山里,"92","60","32","918","494","424","332","132","200",113Y06M
"64000",高雄市,"64000020",鼓山區,64000020-037,哨船頭里,"48","26","22","658","354","304","281","128","153",113Y06M
"64000",高雄市,"64000020",鼓山區,64000020-038,桃源里,"36","17","19","364","207","157","137","88","49",113Y06M
"64000",高雄市,"64000030",左營區,64000030-001,進學里,"65","34","31","1938","1185","753","693","336","357",113Y06M
"64000",高雄市,"64000030",左營區,64000030-002,尾西里,"38","20","18","690","356","334","264","123","141",113Y06M
"64000",高雄市,"64000030",左營區,64000030-003,頂北里,"24","11","13","352","180","172","159","76","83",113Y06M
"64000",高雄市,"64000030",左營區,64000030-004,中北里,"26","13","13","374","197","177","177","82","95",113Y06M
"64000",高雄市,"64000030",左營區,64000030-005,中南里,"15","6","9","299","175","124","156","79","77",113Y06M
"64000",高雄市,"64000030",左營區,64000030-006,廟東里,"54","28","26","576","311","265","202","97","105",113Y06M
"64000",高雄市,"64000030",左營區,64000030-007,廟北里,"52","27","25","550","308","242","254","105","149",113Y06M
"64000",高雄市,"64000030",左營區,64000030-008,尾南里,"40","22","18","499","250","249","192","87","105",113Y06M
"64000",高雄市,"64000030",左營區,64000030-009,尾北里,"253","115","138","2498","1290","1208","721","310","411",113Y06M
"64000",高雄市,"64000030",左營區,64000030-011,屏山里,"79","36","43","1077","541","536","413","127","286",113Y06M
"64000",高雄市,"64000030",左營區,64000030-012,祥和里,"14","9","5","255","138","117","89","23","66",113Y06M
"64000",高雄市,"64000030",左營區,64000030-013,永清里,"404","205","199","925","461","464","107","46","61",113Y06M
"64000",高雄市,"64000030",左營區,64000030-015,莒光里,"166","92","74","1193","620","573","469","178","291",113Y06M
"64000",高雄市,"64000030",左營區,64000030-016,光輝里,"334","180","154","1756","885","871","696","287","409",113Y06M
"64000",高雄市,"64000030",左營區,64000030-017,合群里,"199","112","87","1698","900","798","850","344","506",113Y06M
"64000",高雄市,"64000030",左營區,64000030-019,明建里,"102","46","56","705","339","366","116","51","65",113Y06M
"64000",高雄市,"64000030",左營區,64000030-021,頂西里,"43","23","20","632","337","295","257","100","157",113Y06M
"64000",高雄市,"64000030",左營區,64000030-022,聖后里,"45","25","20","462","246","216","237","120","117",113Y06M
"64000",高雄市,"64000030",左營區,64000030-023,聖西里,"25","15","10","221","127","94","85","47","38",113Y06M
"64000",高雄市,"64000030",左營區,64000030-024,聖南里,"45","17","28","353","172","181","137","68","69",113Y06M
"64000",高雄市,"64000030",左營區,64000030-025,城南里,"22","11","11","309","167","142","145","74","71",113Y06M
"64000",高雄市,"64000030",左營區,64000030-026,路東里,"32","16","16","475","252","223","200","103","97",113Y06M
"64000",高雄市,"64000030",左營區,64000030-027,?北里,"21","12","9","268","146","122","116","54","62",113Y06M
"64000",高雄市,"64000030",左營區,64000030-028,?南里,"38","24","14","412","227","185","150","75","75",113Y06M
"64000",高雄市,"64000030",左營區,64000030-029,埤西里,"32","17","15","515","282","233","302","142","160",113Y06M
"64000",高雄市,"64000030",左營區,64000030-030,埤北里,"49","27","22","780","416","364","411","177","234",113Y06M
"64000",高雄市,"64000030",左營區,64000030-031,埤東里,"39","18","21","556","286","270","302","153","149",113Y06M
"64000",高雄市,"64000030",左營區,64000030-032,海勝里,"360","190","170","4095","2110","1985","1491","537","954",113Y06M
"64000",高雄市,"64000030",左營區,64000030-034,崇實里,"432","226","206","2932","1396","1536","530","237","293",113Y06M
"64000",高雄市,"64000030",左營區,64000030-035,自助里,"237","111","126","1921","893","1028","194","82","112",113Y06M
"64000",高雄市,"64000030",左營區,64000030-036,果貿里,"199","113","86","1959","951","1008","756","288","468",113Y06M
"64000",高雄市,"64000030",左營區,64000030-037,果惠里,"90","49","41","986","472","514","418","160","258",113Y06M
"64000",高雄市,"64000030",左營區,64000030-038,果峰里,"102","48","54","1041","537","504","462","170","292",113Y06M
"64000",高雄市,"64000030",左營區,64000030-039,新下里,"1877","979","898","11863","5464","6399","2613","1078","1535",113Y06M
"64000",高雄市,"64000030",左營區,64000030-040,新上里,"3765","1893","1872","21294","9871","11423","5042","2191","2851",113Y06M
"64000",高雄市,"64000030",左營區,64000030-041,新中里,"647","333","314","3591","1790","1801","1142","521","621",113Y06M
"64000",高雄市,"64000030",左營區,64000030-042,新光里,"2418","1271","1147","12006","5633","6373","2224","952","1272",113Y06M
"64000",高雄市,"64000030",左營區,64000030-043,菜公里,"4829","2481","2348","25931","12287","13644","4219","1775","2444",113Y06M
"64000",高雄市,"64000030",左營區,64000030-044,福山里,"7545","3896","3649","33167","15429","17738","4596","1898","2698",113Y06M
"64000",高雄市,"64000040",楠梓區,64000040-001,清豐里,"5047","2608","2439","20475","9941","10534","3011","1338","1673",113Y06M
"64000",高雄市,"64000040",楠梓區,64000040-002,東寧里,"1231","634","597","4214","1936","2278","693","293","400",113Y06M
"64000",高雄市,"64000040",楠梓區,64000040-003,五常里,"1230","638","592","5520","2674","2846","1056","484","572",113Y06M
"64000",高雄市,"64000040",楠梓區,64000040-004,享平里,"496","253","243","2525","1189","1336","646","283","363",113Y06M
"64000",高雄市,"64000040",楠梓區,64000040-005,中陽里,"612","321","291","2681","1311","1370","671","291","380",113Y06M
"64000",高雄市,"64000040",楠梓區,64000040-006,惠楠里,"323","164","159","2603","1398","1205","656","307","349",113Y06M
"64000",高雄市,"64000040",楠梓區,64000040-007,惠民里,"669","369","300","3815","1884","1931","848","370","478",113Y06M
"64000",高雄市,"64000040",楠梓區,64000040-008,惠豐里,"461","263","198","4008","1938","2070","868","371","497",113Y06M
"64000",高雄市,"64000040",楠梓區,64000040-009,錦屏里,"174","90","84","2084","1072","1012","734","336","398",113Y06M
"64000",高雄市,"64000040",楠梓區,64000040-010,玉屏里,"158","76","82","1507","807","700","488","221","267",113Y06M
"64000",高雄市,"64000040",楠梓區,64000040-011,金田里,"468","251","217","3628","1795","1833","718","299","419",113Y06M
"64000",高雄市,"64000040",楠梓區,64000040-012,稔田里,"116","68","48","1136","593","543","369","179","190",113Y06M
"64000",高雄市,"64000040",楠梓區,64000040-013,瑞屏里,"377","203","174","2672","1331","1341","820","345","475",113Y06M
"64000",高雄市,"64000040",楠梓區,64000040-014,翠屏里,"1825","974","851","13882","6766","7116","2475","1053","1422",113Y06M
"64000",高雄市,"64000040",楠梓區,64000040-015,宏南里,"114","60","54","401","177","224","265","132","133",113Y06M
"64000",高雄市,"64000040",楠梓區,64000040-016,宏毅里,"494","249","245","1316","653","663","687","318","369",113Y06M
"64000",高雄市,"64000040",楠梓區,64000040-017,宏榮里,"565","295","270","1929","913","1016","615","332","283",113Y06M
"64000",高雄市,"64000040",楠梓區,64000040-018,廣昌里,"290","146","144","2184","1116","1068","736","279","457",113Y06M
"64000",高雄市,"64000040",楠梓區,64000040-019,久昌里,"393","211","182","2311","1135","1176","519","207","312",113Y06M
"64000",高雄市,"64000040",楠梓區,64000040-020,大昌里,"211","106","105","1601","826","775","477","161","316",113Y06M
"64000",高雄市,"64000040",楠梓區,64000040-021,福昌里,"219","117","102","1601","834","767","479","214","265",113Y06M
"64000",高雄市,"64000040",楠梓區,64000040-022,盛昌里,"797","415","382","4502","2264","2238","1050","463","587",113Y06M
"64000",高雄市,"64000040",楠梓區,64000040-023,泰昌里,"177","94","83","1048","535","513","343","149","194",113Y06M
"64000",高雄市,"64000040",楠梓區,64000040-024,興昌里,"729","376","353","3526","1786","1740","835","362","473",113Y06M
"64000",高雄市,"64000040",楠梓區,64000040-025,建昌里,"318","168","150","1985","993","992","580","255","325",113Y06M
"64000",高雄市,"64000040",楠梓區,64000040-026,宏昌里,"568","302","266","2643","1258","1385","640","282","358",113Y06M
"64000",高雄市,"64000040",楠梓區,64000040-027,和昌里,"197","105","92","1406","698","708","543","236","307",113Y06M
"64000",高雄市,"64000040",楠梓區,64000040-028,慶昌里,"419","209","210","2201","1064","1137","876","415","461",113Y06M
"64000",高雄市,"64000040",楠梓區,64000040-029,隆昌里,"359","185","174","2389","1192","1197","843","368","475",113Y06M
"64000",高雄市,"64000040",楠梓區,64000040-030,秀昌里,"263","131","132","1561","759","802","478","211","267",113Y06M
"64000",高雄市,"64000040",楠梓區,64000040-031,裕昌里,"918","493","425","4002","1958","2044","792","329","463",113Y06M
"64000",高雄市,"64000040",楠梓區,64000040-032,國昌里,"508","281","227","2766","1408","1358","724","314","410",113Y06M
"64000",高雄市,"64000040",楠梓區,64000040-033,加昌里,"1393","705","688","6817","3277","3540","1613","690","923",113Y06M
"64000",高雄市,"64000040",楠梓區,64000040-034,仁昌里,"901","488","413","4343","2026","2317","840","337","503",113Y06M
"64000",高雄市,"64000040",楠梓區,64000040-035,藍田里,"2274","1183","1091","8014","3880","4134","835","361","474",113Y06M
"64000",高雄市,"64000040",楠梓區,64000040-036,中興里,"494","254","240","2107","1060","1047","305","135","170",113Y06M
"64000",高雄市,"64000040",楠梓區,64000040-037,中和里,"1596","806","790","5364","2642","2722","523","239","284",113Y06M
"64000",高雄市,"64000050",三民區,64000050-001,鼎金里,"404","200","204","3035","1503","1532","834","381","453",113Y06M
"64000",高雄市,"64000050",三民區,64000050-002,鼎盛里,"1208","637","571","6204","2963","3241","1419","641","778",113Y06M
"64000",高雄市,"64000050",三民區,64000050-003,鼎強里,"517","272","245","3026","1497","1529","851","378","473",113Y06M
"64000",高雄市,"64000050",三民區,64000050-004,鼎力里,"498","267","231","3032","1469","1563","892","396","496",113Y06M
"64000",高雄市,"64000050",三民區,64000050-005,鼎西里,"704","352","352","5772","2780","2992","1389","586","803",113Y06M
"64000",高雄市,"64000050",三民區,64000050-006,鼎中里,"311","157","154","2924","1435","1489","857","374","483",113Y06M
"64000",高雄市,"64000050",三民區,64000050-007,鼎泰里,"3228","1646","1582","18014","8411","9603","3691","1577","2114",113Y06M
"64000",高雄市,"64000050",三民區,64000050-008,本館里,"741","402","339","6657","3228","3429","1837","832","1005",113Y06M
"64000",高雄市,"64000050",三民區,64000050-009,本和里,"679","350","329","5784","2786","2998","1443","630","813",113Y06M
"64000",高雄市,"64000050",三民區,64000050-010,本文里,"152","74","78","1401","684","717","469","219","250",113Y06M
"64000",高雄市,"64000050",三民區,64000050-011,本武里,"318","169","149","1273","618","655","395","185","210",113Y06M
"64000",高雄市,"64000050",三民區,64000050-012,本元里,"1005","485","520","4066","1895","2171","1082","477","605",113Y06M
"64000",高雄市,"64000050",三民區,64000050-013,本安里,"1140","548","592","3456","1643","1813","919","422","497",113Y06M
"64000",高雄市,"64000050",三民區,64000050-014,本上里,"1290","672","618","3514","1562","1952","1052","473","579",113Y06M
"64000",高雄市,"64000050",三民區,64000050-015,本揚里,"1960","1016","944","5770","2638","3132","1628","771","857",113Y06M
"64000",高雄市,"64000050",三民區,64000050-016,寶獅里,"309","161","148","2509","1221","1288","920","412","508",113Y06M
"64000",高雄市,"64000050",三民區,64000050-017,寶德里,"463","243","220","3738","1818","1920","1149","523","626",113Y06M
"64000",高雄市,"64000050",三民區,64000050-018,寶泰里,"362","192","170","3034","1405","1629","862","389","473",113Y06M
"64000",高雄市,"64000050",三民區,64000050-019,寶興里,"634","332","302","5086","2401","2685","1464","622","842",113Y06M
"64000",高雄市,"64000050",三民區,64000050-020,寶中里,"382","206","176","2060","1012","1048","661","286","375",113Y06M
"64000",高雄市,"64000050",三民區,64000050-021,寶華里,"520","270","250","2384","1088","1296","710","320","390",113Y06M
"64000",高雄市,"64000050",三民區,64000050-022,寶國里,"1641","825","816","6312","2897","3415","1440","657","783",113Y06M
"64000",高雄市,"64000050",三民區,64000050-023,寶民里,"508","276","232","2334","1119","1215","715","337","378",113Y06M
"64000",高雄市,"64000050",三民區,64000050-024,寶慶里,"451","235","216","1982","941","1041","640","286","354",113Y06M
"64000",高雄市,"64000050",三民區,64000050-025,寶業里,"1362","692","670","4854","2212","2642","1132","514","618",113Y06M
"64000",高雄市,"64000050",三民區,64000050-026,寶盛里,"473","247","226","3636","1760","1876","1184","520","664",113Y06M
"64000",高雄市,"64000050",三民區,64000050-027,寶安里,"697","373","324","5369","2516","2853","1616","703","913",113Y06M
"64000",高雄市,"64000050",三民區,64000050-028,寶龍里,"502","249","253","2963","1477","1486","1029","453","576",113Y06M
"64000",高雄市,"64000050",三民區,64000050-029,寶珠里,"374","190","184","5255","2935","2320","1543","748","795",113Y06M
"64000",高雄市,"64000050",三民區,64000050-030,寶玉里,"1654","852","802","6654","3039","3615","1542","706","836",113Y06M
"64000",高雄市,"64000050",三民區,64000050-031,灣子里,"273","148","125","3170","1576","1594","822","336","486",113Y06M
"64000",高雄市,"64000050",三民區,64000050-032,灣愛里,"243","134","109","2253","1164","1089","635","262","373",113Y06M
"64000",高雄市,"64000050",三民區,64000050-033,灣中里,"371","202","169","4170","2041","2129","1162","490","672",113Y06M
"64000",高雄市,"64000050",三民區,64000050-034,灣華里,"132","68","64","1936","965","971","605","260","345",113Y06M
"64000",高雄市,"64000050",三民區,64000050-035,灣勝里,"124","68","56","1222","622","600","533","227","306",113Y06M
"64000",高雄市,"64000050",三民區,64000050-036,灣利里,"209","101","108","2123","1098","1025","867","381","486",113Y06M
"64000",高雄市,"64000050",三民區,64000050-037,灣復里,"235","130","105","2766","1359","1407","745","323","422",113Y06M
"64000",高雄市,"64000050",三民區,64000050-038,正興里,"1805","976","829","10087","4743","5344","2151","919","1232",113Y06M
"64000",高雄市,"64000050",三民區,64000050-039,正順里,"487","245","242","2863","1351","1512","858","378","480",113Y06M
"64000",高雄市,"64000050",三民區,64000050-040,灣興里,"256","129","127","1351","671","680","449","197","252",113Y06M
"64000",高雄市,"64000050",三民區,64000050-041,灣成里,"283","137","146","2405","1190","1215","576","240","336",113Y06M
"64000",高雄市,"64000050",三民區,64000050-042,安康里,"237","119","118","1889","959","930","732","319","413",113Y06M
"64000",高雄市,"64000050",三民區,64000050-043,安寧里,"125","67","58","1222","645","577","489","218","271",113Y06M
"64000",高雄市,"64000050",三民區,64000050-044,安吉里,"668","332","336","3679","1703","1976","1073","463","610",113Y06M
"64000",高雄市,"64000050",三民區,64000050-045,安發里,"547","276","271","3130","1465","1665","1147","492","655",113Y06M
"64000",高雄市,"64000050",三民區,64000050-046,安東里,"344","159","185","2211","1075","1136","889","397","492",113Y06M
"64000",高雄市,"64000050",三民區,64000050-047,安和里,"295","147","148","1862","914","948","684","301","383",113Y06M
"64000",高雄市,"64000050",三民區,64000050-048,達德里,"134","82","52","830","414","416","399","188","211",113Y06M
"64000",高雄市,"64000050",三民區,64000050-049,達明里,"195","97","98","1025","505","520","477","201","276",113Y06M
"64000",高雄市,"64000050",三民區,64000050-050,達仁里,"169","85","84","953","461","492","413","177","236",113Y06M
"64000",高雄市,"64000050",三民區,64000050-051,達勇里,"79","46","33","619","317","302","271","127","144",113Y06M
"64000",高雄市,"64000050",三民區,64000050-052,同德里,"218","105","113","1824","924","900","789","367","422",113Y06M
"64000",高雄市,"64000050",三民區,64000050-053,德智里,"211","111","100","1508","714","794","642","284","358",113Y06M
"64000",高雄市,"64000050",三民區,64000050-054,德仁里,"184","90","94","1295","646","649","522","228","294",113Y06M
"64000",高雄市,"64000050",三民區,64000050-055,安生里,"129","65","64","1312","638","674","397","190","207",113Y06M
"64000",高雄市,"64000050",三民區,64000050-056,德東里,"68","38","30","497","251","246","224","93","131",113Y06M
"64000",高雄市,"64000050",三民區,64000050-057,德行里,"80","39","41","702","344","358","332","170","162",113Y06M
"64000",高雄市,"64000050",三民區,64000050-058,精華里,"117","62","55","991","499","492","468","215","253",113Y06M
"64000",高雄市,"64000050",三民區,64000050-059,民享里,"160","94","66","1260","627","633","612","279","333",113Y06M
"64000",高雄市,"64000050",三民區,64000050-060,安宜里,"317","164","153","2265","1143","1122","820","326","494",113Y06M
"64000",高雄市,"64000050",三民區,64000050-061,安泰里,"350","192","158","2633","1307","1326","1043","442","601",113Y06M
"64000",高雄市,"64000050",三民區,64000050-062,安邦里,"404","215","189","2698","1334","1364","1037","457","580",113Y06M
"64000",高雄市,"64000050",三民區,64000050-063,十全里,"173","90","83","1250","597","653","408","175","233",113Y06M
"64000",高雄市,"64000050",三民區,64000050-064,十美里,"137","71","66","1166","596","570","533","235","298",113Y06M
"64000",高雄市,"64000050",三民區,64000050-065,德北里,"239","127","112","1676","794","882","561","259","302",113Y06M
"64000",高雄市,"64000050",三民區,64000050-066,立誠里,"58","29","29","459","220","239","233","104","129",113Y06M
"64000",高雄市,"64000050",三民區,64000050-067,立業里,"75","35","40","584","289","295","267","124","143",113Y06M
"64000",高雄市,"64000050",三民區,64000050-068,港東里,"80","37","43","892","449","443","443","194","249",113Y06M
"64000",高雄市,"64000050",三民區,64000050-069,港新里,"257","141","116","1082","512","570","399","177","222",113Y06M
"64000",高雄市,"64000050",三民區,64000050-070,港西里,"35","13","22","474","247","227","256","125","131",113Y06M
"64000",高雄市,"64000050",三民區,64000050-072,博愛里,"60","32","28","792","391","401","320","146","174",113Y06M
"64000",高雄市,"64000050",三民區,64000050-073,博惠里,"560","297","263","2790","1361","1429","1150","492","658",113Y06M
"64000",高雄市,"64000050",三民區,64000050-074,長明里,"80","43","37","720","375","345","277","119","158",113Y06M
"64000",高雄市,"64000050",三民區,64000050-075,建東里,"57","29","28","878","394","484","286","125","161",113Y06M
"64000",高雄市,"64000050",三民區,64000050-076,興德里,"139","72","67","1467","693","774","487","219","268",113Y06M
"64000",高雄市,"64000050",三民區,64000050-077,鳳南里,"91","51","40","685","342","343","294","134","160",113Y06M
"64000",高雄市,"64000050",三民區,64000050-078,鳳北里,"95","49","46","861","430","431","379","185","194",113Y06M
"64000",高雄市,"64000050",三民區,64000050-079,德西里,"267","150","117","1892","839","1053","294","138","156",113Y06M
"64000",高雄市,"64000050",三民區,64000050-081,豐裕里,"180","100","80","1691","860","831","632","268","364",113Y06M
"64000",高雄市,"64000050",三民區,64000050-082,川東里,"81","37","44","882","461","421","281","136","145",113Y06M
"64000",高雄市,"64000050",三民區,64000050-083,裕民里,"137","78","59","1043","526","517","259","109","150",113Y06M
"64000",高雄市,"64000050",三民區,64000050-084,力行里,"65","34","31","704","377","327","306","153","153",113Y06M
"64000",高雄市,"64000050",三民區,64000050-085,千歲里,"92","52","40","723","361","362","356","157","199",113Y06M
"64000",高雄市,"64000050",三民區,64000050-086,立德里,"89","42","47","837","414","423","330","141","189",113Y06M
"64000",高雄市,"64000050",三民區,64000050-087,千北里,"76","40","36","707","363","344","284","112","172",113Y06M
"64000",高雄市,"64000050",三民區,64000050-088,千秋里,"126","57","69","1361","703","658","570","252","318",113Y06M
"64000",高雄市,"64000060",新興區,64000060-001,浩然里,"114","65","49","1178","557","621","573","245","328",113Y06M
"64000",高雄市,"64000060",新興區,64000060-002,振成里,"69","35","34","644","312","332","349","145","204",113Y06M
"64000",高雄市,"64000060",新興區,64000060-003,德生里,"404","214","190","2084","920","1164","792","335","457",113Y06M
"64000",高雄市,"64000060",新興區,64000060-004,振華里,"83","48","35","676","335","341","335","147","188",113Y06M
"64000",高雄市,"64000060",新興區,64000060-005,正氣里,"79","38","41","851","405","446","464","208","256",113Y06M
"64000",高雄市,"64000060",新興區,64000060-006,德政里,"47","20","27","438","201","237","183","85","98",113Y06M
"64000",高雄市,"64000060",新興區,64000060-007,仁聲里,"76","38","38","754","329","425","274","112","162",113Y06M
"64000",高雄市,"64000060",新興區,64000060-008,德望里,"165","97","68","1246","611","635","567","251","316",113Y06M
"64000",高雄市,"64000060",新興區,64000060-009,華聲里,"70","37","33","599","301","298","292","129","163",113Y06M
"64000",高雄市,"64000060",新興區,64000060-010,蕉園里,"49","27","22","463","243","220","229","112","117",113Y06M
"64000",高雄市,"64000060",新興區,64000060-011,永寧里,"104","59","45","972","463","509","423","189","234",113Y06M
"64000",高雄市,"64000060",新興區,64000060-012,玉衡里,"40","20","20","463","252","211","197","83","114",113Y06M
"64000",高雄市,"64000060",新興區,64000060-013,順昌里,"490","251","239","1669","786","883","531","246","285",113Y06M
"64000",高雄市,"64000060",新興區,64000060-014,文昌里,"755","391","364","2256","1055","1201","752","328","424",113Y06M
"64000",高雄市,"64000060",新興區,64000060-015,光耀里,"475","236","239","1585","750","835","631","284","347",113Y06M
"64000",高雄市,"64000060",新興區,64000060-016,興昌里,"313","160","153","1100","495","605","463","211","252",113Y06M
"64000",高雄市,"64000060",新興區,64000060-017,開平里,"649","339","310","2465","1121","1344","896","408","488",113Y06M
"64000",高雄市,"64000060",新興區,64000060-018,成功里,"116","64","52","938","432","506","400","184","216",113Y06M
"64000",高雄市,"64000060",新興區,64000060-019,新江里,"83","41","42","761","371","390","302","134","168",113Y06M
"64000",高雄市,"64000060",新興區,64000060-020,黎明里,"55","35","20","547","287","260","247","123","124",113Y06M
"64000",高雄市,"64000060",新興區,64000060-021,愛平里,"87","43","44","660","321","339","305","142","163",113Y06M
"64000",高雄市,"64000060",新興區,64000060-022,南港里,"195","110","85","1329","668","661","564","256","308",113Y06M
"64000",高雄市,"64000060",新興區,64000060-023,中東里,"418","223","195","1974","976","998","773","350","423",113Y06M
"64000",高雄市,"64000060",新興區,64000060-024,明莊里,"35","17","18","452","227","225","210","96","114",113Y06M
"64000",高雄市,"64000060",新興區,64000060-025,大明里,"72","38","34","714","331","383","318","140","178",113Y06M
"64000",高雄市,"64000060",新興區,64000060-026,秋山里,"50","28","22","743","352","391","269","128","141",113Y06M
"64000",高雄市,"64000060",新興區,64000060-027,長驛里,"43","21","22","686","330","356","218","107","111",113Y06M
"64000",高雄市,"64000060",新興區,64000060-028,建興里,"50","27","23","647","315","332","263","128","135",113Y06M
"64000",高雄市,"64000060",新興區,64000060-029,建華里,"36","18","18","604","306","298","245","110","135",113Y06M
"64000",高雄市,"64000060",新興區,64000060-030,漢民里,"65","33","32","493","245","248","234","91","143",113Y06M
"64000",高雄市,"64000060",新興區,64000060-031,榮治里,"48","22","26","497","233","264","187","86","101",113Y06M
"64000",高雄市,"64000060",新興區,64000060-032,東坡里,"66","36","30","754","384","370","394","177","217",113Y06M
"64000",高雄市,"64000070",前金區,64000070-001,三川里,"61","34","27","697","332","365","211","93","118",113Y06M
"64000",高雄市,"64000070",前金區,64000070-002,草江里,"99","49","50","1060","475","585","339","149","190",113Y06M
"64000",高雄市,"64000070",前金區,64000070-003,長城里,"81","42","39","964","477","487","386","161","225",113Y06M
"64000",高雄市,"64000070",前金區,64000070-004,北金里,"49","27","22","576","277","299","226","95","131",113Y06M
"64000",高雄市,"64000070",前金區,64000070-005,東金里,"72","36","36","625","287","338","307","139","168",113Y06M
"64000",高雄市,"64000070",前金區,64000070-006,新生里,"324","173","151","2697","1268","1429","960","418","542",113Y06M
"64000",高雄市,"64000070",前金區,64000070-007,後金里,"49","23","26","385","214","171","215","97","118",113Y06M
"64000",高雄市,"64000070",前金區,64000070-008,長興里,"98","51","47","856","403","453","376","167","209",113Y06M
"64000",高雄市,"64000070",前金區,64000070-009,青山里,"151","67","84","1448","646","802","523","234","289",113Y06M
"64000",高雄市,"64000070",前金區,64000070-010,民生里,"77","35","42","605","264","341","260","116","144",113Y06M
"64000",高雄市,"64000070",前金區,64000070-011,復元里,"76","38","38","706","338","368","343","143","200",113Y06M
"64000",高雄市,"64000070",前金區,64000070-012,林投里,"84","49","35","730","413","317","343","179","164",113Y06M
"64000",高雄市,"64000070",前金區,64000070-013,國民里,"71","32","39","622","293","329","303","149","154",113Y06M
"64000",高雄市,"64000070",前金區,64000070-014,社東里,"141","69","72","950","431","519","486","198","288",113Y06M
"64000",高雄市,"64000070",前金區,64000070-015,社西里,"86","39","47","858","389","469","308","128","180",113Y06M
"64000",高雄市,"64000070",前金區,64000070-016,博孝里,"80","49","31","733","344","389","275","125","150",113Y06M
"64000",高雄市,"64000070",前金區,64000070-017,長生里,"130","69","61","1166","549","617","533","229","304",113Y06M
"64000",高雄市,"64000070",前金區,64000070-018,榮復里,"76","43","33","699","330","369","321","145","176",113Y06M
"64000",高雄市,"64000070",前金區,64000070-019,文西里,"81","43","38","645","313","332","301","120","181",113Y06M
"64000",高雄市,"64000070",前金區,64000070-020,文東里,"66","34","32","789","379","410","353","149","204",113Y06M
"64000",高雄市,"64000080",苓雅區,64000080-001,博仁里,"51","30","21","451","203","248","181","77","104",113Y06M
"64000",高雄市,"64000080",苓雅區,64000080-002,苓洲里,"91","49","42","1126","531","595","432","181","251",113Y06M
"64000",高雄市,"64000080",苓雅區,64000080-003,苓昇里,"67","37","30","810","410","400","338","141","197",113Y06M
"64000",高雄市,"64000080",苓雅區,64000080-004,苓中里,"117","58","59","1206","578","628","375","152","223",113Y06M
"64000",高雄市,"64000080",苓雅區,64000080-005,苓雅里,"116","56","60","1046","481","565","380","150","230",113Y06M
"64000",高雄市,"64000080",苓雅區,64000080-006,苓東里,"66","39","27","984","477","507","405","167","238",113Y06M
"64000",高雄市,"64000080",苓雅區,64000080-007,城北里,"167","83","84","1338","609","729","401","177","224",113Y06M
"64000",高雄市,"64000080",苓雅區,64000080-008,城西里,"54","28","26","344","172","172","132","52","80",113Y06M
"64000",高雄市,"64000080",苓雅區,64000080-009,城東里,"181","100","81","1421","666","755","480","212","268",113Y06M
"64000",高雄市,"64000080",苓雅區,64000080-010,意誠里,"339","174","165","2913","1359","1554","967","406","561",113Y06M
"64000",高雄市,"64000080",苓雅區,64000080-011,鼓中里,"69","24","45","616","308","308","280","134","146",113Y06M
"64000",高雄市,"64000080",苓雅區,64000080-012,田西里,"113","58","55","1000","485","515","341","151","190",113Y06M
"64000",高雄市,"64000080",苓雅區,64000080-013,人和里,"143","68","75","1228","610","618","483","199","284",113Y06M
"64000",高雄市,"64000080",苓雅區,64000080-014,仁政里,"89","46","43","827","398","429","391","173","218",113Y06M
"64000",高雄市,"64000080",苓雅區,64000080-015,廣澤里,"129","70","59","1153","592","561","539","245","294",113Y06M
"64000",高雄市,"64000080",苓雅區,64000080-016,美田里,"92","50","42","765","382","383","339","131","208",113Y06M
"64000",高雄市,"64000080",苓雅區,64000080-017,華堂里,"208","103","105","2067","989","1078","856","349","507",113Y06M
"64000",高雄市,"64000080",苓雅區,64000080-018,日中里,"128","58","70","1433","691","742","651","280","371",113Y06M
"64000",高雄市,"64000080",苓雅區,64000080-019,普照里,"285","143","142","2180","1046","1134","868","372","496",113Y06M
"64000",高雄市,"64000080",苓雅區,64000080-020,和煦里,"211","107","104","1310","667","643","559","259","300",113Y06M
"64000",高雄市,"64000080",苓雅區,64000080-021,晴朗里,"244","120","124","2115","1146","969","656","360","296",113Y06M
"64000",高雄市,"64000080",苓雅區,64000080-022,普天里,"540","279","261","2633","1214","1419","886","397","489",113Y06M
"64000",高雄市,"64000080",苓雅區,64000080-023,林富里,"745","399","346","1702","719","983","576","266","310",113Y06M
"64000",高雄市,"64000080",苓雅區,64000080-024,林圍里,"646","343","303","1668","715","953","595","262","333",113Y06M
"64000",高雄市,"64000080",苓雅區,64000080-025,林安里,"451","243","208","1208","535","673","368","146","222",113Y06M
"64000",高雄市,"64000080",苓雅區,64000080-026,光華里,"52","24","28","461","249","212","208","88","120",113Y06M
"64000",高雄市,"64000080",苓雅區,64000080-027,林興里,"111","72","39","869","442","427","328","140","188",113Y06M
"64000",高雄市,"64000080",苓雅區,64000080-028,林華里,"226","114","112","1780","879","901","767","327","440",113Y06M
"64000",高雄市,"64000080",苓雅區,64000080-029,林西里,"106","50","56","1019","498","521","487","203","284",113Y06M
"64000",高雄市,"64000080",苓雅區,64000080-030,林中里,"153","79","74","1834","927","907","867","380","487",113Y06M
"64000",高雄市,"64000080",苓雅區,64000080-031,林泉里,"534","275","259","1289","553","736","530","222","308",113Y06M
"64000",高雄市,"64000080",苓雅區,64000080-032,林南里,"818","426","392","1956","827","1129","843","368","475",113Y06M
"64000",高雄市,"64000080",苓雅區,64000080-033,中正里,"796","419","377","2052","880","1172","696","294","402",113Y06M
"64000",高雄市,"64000080",苓雅區,64000080-034,尚義里,"472","230","242","1212","576","636","402","178","224",113Y06M
"64000",高雄市,"64000080",苓雅區,64000080-035,同慶里,"933","464","469","1747","775","972","378","156","222",113Y06M
"64000",高雄市,"64000080",苓雅區,64000080-036,凱旋里,"536","269","267","1624","770","854","516","243","273",113Y06M
"64000",高雄市,"64000080",苓雅區,64000080-037,安祥里,"628","331","297","1959","889","1070","793","342","451",113Y06M
"64000",高雄市,"64000080",苓雅區,64000080-038,奏捷里,"257","138","119","1092","504","588","397","173","224",113Y06M
"64000",高雄市,"64000080",苓雅區,64000080-039,福壽里,"102","45","57","977","528","449","365","168","197",113Y06M
"64000",高雄市,"64000080",苓雅區,64000080-040,福南里,"88","44","44","1196","614","582","459","208","251",113Y06M
"64000",高雄市,"64000080",苓雅區,64000080-041,五權里,"128","68","60","1688","802","886","579","268","311",113Y06M
"64000",高雄市,"64000080",苓雅區,64000080-042,民主里,"327","164","163","2913","1458","1455","1211","509","702",113Y06M
"64000",高雄市,"64000080",苓雅區,64000080-043,林德里,"127","56","71","1188","549","639","523","228","295",113Y06M
"64000",高雄市,"64000080",苓雅區,64000080-044,林貴里,"197","107","90","1347","646","701","449","188","261",113Y06M
"64000",高雄市,"64000080",苓雅區,64000080-045,林榮里,"408","208","200","2890","1392","1498","1028","440","588",113Y06M
"64000",高雄市,"64000080",苓雅區,64000080-046,英明里,"155","73","82","1273","617","656","505","213","292",113Y06M
"64000",高雄市,"64000080",苓雅區,64000080-047,林靖里,"121","61","60","1052","503","549","454","204","250",113Y06M
"64000",高雄市,"64000080",苓雅區,64000080-048,朝陽里,"127","63","64","932","450","482","404","173","231",113Y06M
"64000",高雄市,"64000080",苓雅區,64000080-049,福隆里,"256","136","120","1949","980","969","762","335","427",113Y06M
"64000",高雄市,"64000080",苓雅區,64000080-050,福祥里,"91","47","44","925","493","432","295","122","173",113Y06M
"64000",高雄市,"64000080",苓雅區,64000080-051,福海里,"57","33","24","706","360","346","280","113","167",113Y06M
"64000",高雄市,"64000080",苓雅區,64000080-052,福康里,"150","83","67","1242","639","603","481","210","271",113Y06M
"64000",高雄市,"64000080",苓雅區,64000080-053,福人里,"149","82","67","1412","741","671","535","211","324",113Y06M
"64000",高雄市,"64000080",苓雅區,64000080-054,福地里,"227","114","113","1786","934","852","665","274","391",113Y06M
"64000",高雄市,"64000080",苓雅區,64000080-055,福居里,"180","95","85","1799","963","836","719","302","417",113Y06M
"64000",高雄市,"64000080",苓雅區,64000080-056,福東里,"207","92","115","1866","899","967","619","273","346",113Y06M
"64000",高雄市,"64000080",苓雅區,64000080-057,福西里,"140","68","72","1362","665","697","429","174","255",113Y06M
"64000",高雄市,"64000080",苓雅區,64000080-058,永康里,"132","73","59","1468","742","726","532","243","289",113Y06M
"64000",高雄市,"64000080",苓雅區,64000080-059,正文里,"274","149","125","1840","879","961","607","247","360",113Y06M
"64000",高雄市,"64000080",苓雅區,64000080-060,正言里,"220","114","106","2122","1005","1117","751","318","433",113Y06M
"64000",高雄市,"64000080",苓雅區,64000080-061,正大里,"614","312","302","3767","1722","2045","1202","522","680",113Y06M
"64000",高雄市,"64000080",苓雅區,64000080-062,五福里,"208","107","101","2448","1228","1220","1050","437","613",113Y06M
"64000",高雄市,"64000080",苓雅區,64000080-063,正心里,"247","127","120","2342","1156","1186","1058","467","591",113Y06M
"64000",高雄市,"64000080",苓雅區,64000080-064,正道里,"366","162","204","2827","1369","1458","1158","475","683",113Y06M
"64000",高雄市,"64000080",苓雅區,64000080-065,正義里,"291","163","128","1720","877","843","556","268","288",113Y06M
"64000",高雄市,"64000080",苓雅區,64000080-066,正仁里,"235","128","107","1760","854","906","618","275","343",113Y06M
"64000",高雄市,"64000080",苓雅區,64000080-067,文昌里,"339","158","181","2506","1236","1270","1021","442","579",113Y06M
"64000",高雄市,"64000080",苓雅區,64000080-068,建軍里,"184","98","86","1444","742","702","507","220","287",113Y06M
"64000",高雄市,"64000080",苓雅區,64000080-069,衛武里,"128","62","66","1261","638","623","563","245","318",113Y06M
"64000",高雄市,"64000090",前鎮區,64000090-001,草衙里,"904","459","445","7495","3813","3682","1828","802","1026",113Y06M
"64000",高雄市,"64000090",前鎮區,64000090-002,明孝里,"228","112","116","1793","937","856","541","226","315",113Y06M
"64000",高雄市,"64000090",前鎮區,64000090-003,明正里,"513","240","273","4014","2102","1912","1093","499","594",113Y06M
"64000",高雄市,"64000090",前鎮區,64000090-004,明義里,"247","135","112","1739","894","845","510","229","281",113Y06M
"64000",高雄市,"64000090",前鎮區,64000090-005,仁愛里,"95","49","46","919","516","403","321","143","178",113Y06M
"64000",高雄市,"64000090",前鎮區,64000090-006,德昌里,"130","69","61","1401","725","676","464","199","265",113Y06M
"64000",高雄市,"64000090",前鎮區,64000090-007,平等里,"220","124","96","2255","1303","952","696","377","319",113Y06M
"64000",高雄市,"64000090",前鎮區,64000090-008,平昌里,"73","35","38","522","273","249","144","58","86",113Y06M
"64000",高雄市,"64000090",前鎮區,64000090-009,明禮里,"125","60","65","1183","625","558","398","165","233",113Y06M
"64000",高雄市,"64000090",前鎮區,64000090-010,信義里,"94","52","42","1002","538","464","317","144","173",113Y06M
"64000",高雄市,"64000090",前鎮區,64000090-011,信德里,"136","76","60","1665","896","769","515","215","300",113Y06M
"64000",高雄市,"64000090",前鎮區,64000090-012,明道里,"55","28","27","749","399","350","293","152","141",113Y06M
"64000",高雄市,"64000090",前鎮區,64000090-013,興化里,"36","19","17","458","245","213","161","72","89",113Y06M
"64000",高雄市,"64000090",前鎮區,64000090-014,興仁里,"45","30","15","468","253","215","172","72","100",113Y06M
"64000",高雄市,"64000090",前鎮區,64000090-015,前鎮里,"69","34","35","919","496","423","337","154","183",113Y06M
"64000",高雄市,"64000090",前鎮區,64000090-016,鎮東里,"57","25","32","1160","622","538","465","208","257",113Y06M
"64000",高雄市,"64000090",前鎮區,64000090-017,鎮榮里,"137","74","63","1427","758","669","523","228","295",113Y06M
"64000",高雄市,"64000090",前鎮區,64000090-018,鎮昌里,"151","78","73","1419","763","656","480","201","279",113Y06M
"64000",高雄市,"64000090",前鎮區,64000090-019,鎮海里,"302","152","150","3013","1533","1480","966","427","539",113Y06M
"64000",高雄市,"64000090",前鎮區,64000090-020,鎮陽里,"45","20","25","625","324","301","291","122","169",113Y06M
"64000",高雄市,"64000090",前鎮區,64000090-021,興邦里,"286","148","138","2451","1229","1222","523","233","290",113Y06M
"64000",高雄市,"64000090",前鎮區,64000090-022,鎮中里,"54","24","30","587","308","279","205","94","111",113Y06M
"64000",高雄市,"64000090",前鎮區,64000090-023,鎮北里,"53","26","27","809","410","399","282","136","146",113Y06M
"64000",高雄市,"64000090",前鎮區,64000090-024,忠純里,"437","248","189","3877","1949","1928","1468","627","841",113Y06M
"64000",高雄市,"64000090",前鎮區,64000090-025,忠誠里,"158","85","73","1339","680","659","540","261","279",113Y06M
"64000",高雄市,"64000090",前鎮區,64000090-028,西山里,"221","128","93","2204","1053","1151","990","441","549",113Y06M
"64000",高雄市,"64000090",前鎮區,64000090-029,民權里,"503","266","237","2871","1331","1540","995","437","558",113Y06M
"64000",高雄市,"64000090",前鎮區,64000090-030,建隆里,"137","66","71","1002","478","524","359","172","187",113Y06M
"64000",高雄市,"64000090",前鎮區,64000090-031,振興里,"183","104","79","1899","893","1006","550","238","312",113Y06M
"64000",高雄市,"64000090",前鎮區,64000090-032,良和里,"216","111","105","1952","937","1015","785","376","409",113Y06M
"64000",高雄市,"64000090",前鎮區,64000090-033,西甲里,"152","77","75","1487","726","761","539","254","285",113Y06M
"64000",高雄市,"64000090",前鎮區,64000090-034,盛興里,"211","125","86","1970","909","1061","714","294","420",113Y06M
"64000",高雄市,"64000090",前鎮區,64000090-035,盛豐里,"263","139","124","2199","1026","1173","816","344","472",113Y06M
"64000",高雄市,"64000090",前鎮區,64000090-036,興中里,"215","113","102","2161","1063","1098","774","331","443",113Y06M
"64000",高雄市,"64000090",前鎮區,64000090-037,興東里,"780","412","368","4399","2094","2305","1280","564","716",113Y06M
"64000",高雄市,"64000090",前鎮區,64000090-038,忠孝里,"361","180","181","2602","1212","1390","821","354","467",113Y06M
"64000",高雄市,"64000090",前鎮區,64000090-039,復國里,"245","129","116","1822","908","914","718","317","401",113Y06M
"64000",高雄市,"64000090",前鎮區,64000090-040,竹內里,"314","157","157","1936","969","967","688","316","372",113Y06M
"64000",高雄市,"64000090",前鎮區,64000090-041,竹東里,"221","113","108","1495","708","787","572","251","321",113Y06M
"64000",高雄市,"64000090",前鎮區,64000090-042,竹南里,"1279","661","618","5720","2653","3067","1218","503","715",113Y06M
"64000",高雄市,"64000090",前鎮區,64000090-043,竹北里,"304","161","143","1951","919","1032","594","269","325",113Y06M
"64000",高雄市,"64000090",前鎮區,64000090-044,竹西里,"420","212","208","2967","1452","1515","1008","450","558",113Y06M
"64000",高雄市,"64000090",前鎮區,64000090-045,竹中里,"424","222","202","2534","1197","1337","875","367","508",113Y06M
"64000",高雄市,"64000090",前鎮區,64000090-046,瑞竹里,"445","222","223","1825","885","940","303","130","173",113Y06M
"64000",高雄市,"64000090",前鎮區,64000090-047,瑞南里,"866","471","395","3609","1782","1827","989","440","549",113Y06M
"64000",高雄市,"64000090",前鎮區,64000090-048,瑞豐里,"426","231","195","2105","1057","1048","550","228","322",113Y06M
"64000",高雄市,"64000090",前鎮區,64000090-049,瑞祥里,"788","414","374","3563","1735","1828","880","379","501",113Y06M
"64000",高雄市,"64000090",前鎮區,64000090-050,瑞東里,"339","168","171","1729","869","860","536","218","318",113Y06M
"64000",高雄市,"64000090",前鎮區,64000090-051,瑞和里,"283","141","142","1426","755","671","400","159","241",113Y06M
"64000",高雄市,"64000090",前鎮區,64000090-052,瑞平里,"544","284","260","2598","1272","1326","777","333","444",113Y06M
"64000",高雄市,"64000090",前鎮區,64000090-053,瑞隆里,"427","208","219","2620","1339","1281","762","331","431",113Y06M
"64000",高雄市,"64000090",前鎮區,64000090-054,瑞北里,"262","139","123","2444","1215","1229","725","300","425",113Y06M
"64000",高雄市,"64000090",前鎮區,64000090-055,瑞西里,"144","70","74","1828","938","890","687","314","373",113Y06M
"64000",高雄市,"64000090",前鎮區,64000090-056,瑞崗里,"202","108","94","1793","913","880","660","278","382",113Y06M
"64000",高雄市,"64000090",前鎮區,64000090-057,瑞興里,"203","118","85","1824","920","904","640","265","375",113Y06M
"64000",高雄市,"64000090",前鎮區,64000090-058,瑞誠里,"233","120","113","1936","968","968","576","261","315",113Y06M
"64000",高雄市,"64000090",前鎮區,64000090-059,瑞文里,"197","112","85","1819","904","915","539","246","293",113Y06M
"64000",高雄市,"64000090",前鎮區,64000090-060,瑞華里,"374","209","165","3405","1644","1761","961","419","542",113Y06M
"64000",高雄市,"64000090",前鎮區,64000090-061,瑞昌里,"347","178","169","2482","1189","1293","633","282","351",113Y06M
"64000",高雄市,"64000100",旗津區,64000100-001,旗下里,"66","29","37","829","442","387","301","154","147",113Y06M
"64000",高雄市,"64000100",旗津區,64000100-002,永安里,"63","38","25","777","407","370","231","109","122",113Y06M
"64000",高雄市,"64000100",旗津區,64000100-003,振興里,"120","58","62","1123","594","529","356","163","193",113Y06M
"64000",高雄市,"64000100",旗津區,64000100-004,慈愛里,"178","84","94","1755","905","850","463","216","247",113Y06M
"64000",高雄市,"64000100",旗津區,64000100-005,復興里,"259","130","129","2265","1159","1106","618","266","352",113Y06M
"64000",高雄市,"64000100",旗津區,64000100-006,中華里,"142","61","81","1139","565","574","315","141","174",113Y06M
"64000",高雄市,"64000100",旗津區,64000100-007,實踐里,"102","51","51","1105","602","503","316","141","175",113Y06M
"64000",高雄市,"64000100",旗津區,64000100-008,北汕里,"222","122","100","2104","1122","982","512","220","292",113Y06M
"64000",高雄市,"64000100",旗津區,64000100-009,南汕里,"130","64","66","1578","854","724","429","219","210",113Y06M
"64000",高雄市,"64000100",旗津區,64000100-010,上竹里,"239","116","123","2107","1096","1011","605","303","302",113Y06M
"64000",高雄市,"64000100",旗津區,64000100-011,中洲里,"109","61","48","1307","681","626","433","217","216",113Y06M
"64000",高雄市,"64000100",旗津區,64000100-012,安順里,"59","34","25","607","343","264","227","115","112",113Y06M
"64000",高雄市,"64000100",旗津區,64000100-013,中興里,"237","129","108","1955","989","966","542","237","305",113Y06M
"64000",高雄市,"64000110",小港區,64000110-001,小港里,"238","120","118","1688","874","814","534","252","282",113Y06M
"64000",高雄市,"64000110",小港區,64000110-002,港口里,"348","170","178","2184","1064","1120","863","430","433",113Y06M
"64000",高雄市,"64000110",小港區,64000110-003,港正里,"335","171","164","1857","938","919","625","283","342",113Y06M
"64000",高雄市,"64000110",小港區,64000110-004,港墘里,"203","102","101","1245","622","623","391","176","215",113Y06M
"64000",高雄市,"64000110",小港區,64000110-005,港明里,"362","179","183","2335","1195","1140","697","297","400",113Y06M
"64000",高雄市,"64000110",小港區,64000110-006,港后里,"391","189","202","2079","1061","1018","495","227","268",113Y06M
"64000",高雄市,"64000110",小港區,64000110-007,港南里,"570","281","289","2827","1459","1368","511","245","266",113Y06M
"64000",高雄市,"64000110",小港區,64000110-008,港興里,"244","125","119","1621","843","778","581","246","335",113Y06M
"64000",高雄市,"64000110",小港區,64000110-009,鳳宮里,"369","186","183","2156","1050","1106","490","229","261",113Y06M
"64000",高雄市,"64000110",小港區,64000110-010,店鎮里,"689","369","320","4605","2296","2309","1123","517","606",113Y06M
"64000",高雄市,"64000110",小港區,64000110-011,大苓里,"254","129","125","1799","868","931","604","272","332",113Y06M
"64000",高雄市,"64000110",小港區,64000110-012,二苓里,"393","187","206","2752","1374","1378","811","375","436",113Y06M
"64000",高雄市,"64000110",小港區,64000110-013,三苓里,"277","132","145","2025","997","1028","656","307","349",113Y06M
"64000",高雄市,"64000110",小港區,64000110-014,正苓里,"490","252","238","3068","1492","1576","851","409","442",113Y06M
"64000",高雄市,"64000110",小港區,64000110-015,順苓里,"650","328","322","3680","1774","1906","786","363","423",113Y06M
"64000",高雄市,"64000110",小港區,64000110-016,六苓里,"435","235","200","2096","973","1123","458","222","236",113Y06M
"64000",高雄市,"64000110",小港區,64000110-017,宏亮里,"514","266","248","2546","1235","1311","625","284","341",113Y06M
"64000",高雄市,"64000110",小港區,64000110-018,山東里,"340","172","168","2264","1142","1122","668","289","379",113Y06M
"64000",高雄市,"64000110",小港區,64000110-019,青島里,"198","111","87","1771","872","899","504","199","305",113Y06M
"64000",高雄市,"64000110",小港區,64000110-020,濟南里,"497","251","246","3280","1629","1651","787","359","428",113Y06M
"64000",高雄市,"64000110",小港區,64000110-021,泰山里,"439","235","204","2596","1272","1324","650","296","354",113Y06M
"64000",高雄市,"64000110",小港區,64000110-022,山明里,"1897","959","938","9905","4794","5111","1912","864","1048",113Y06M
"64000",高雄市,"64000110",小港區,64000110-023,高松里,"640","344","296","3670","1873","1797","926","415","511",113Y06M
"64000",高雄市,"64000110",小港區,64000110-024,松金里,"342","180","162","1977","992","985","560","251","309",113Y06M
"64000",高雄市,"64000110",小港區,64000110-025,松山里,"371","189","182","2472","1241","1231","713","337","376",113Y06M
"64000",高雄市,"64000110",小港區,64000110-026,大坪里,"371","193","178","2524","1278","1246","517","239","278",113Y06M
"64000",高雄市,"64000110",小港區,64000110-027,坪頂里,"915","475","440","5634","2833","2801","957","464","493",113Y06M
"64000",高雄市,"64000110",小港區,64000110-028,孔宅里,"655","335","320","4076","2079","1997","790","349","441",113Y06M
"64000",高雄市,"64000110",小港區,64000110-029,廈莊里,"723","382","341","3809","1872","1937","629","288","341",113Y06M
"64000",高雄市,"64000110",小港區,64000110-030,合作里,"335","179","156","2101","1095","1006","587","267","320",113Y06M
"64000",高雄市,"64000110",小港區,64000110-031,桂林里,"1051","519","532","6478","3215","3263","1405","619","786",113Y06M
"64000",高雄市,"64000110",小港區,64000110-032,中厝里,"515","264","251","2963","1497","1466","655","302","353",113Y06M
"64000",高雄市,"64000110",小港區,64000110-033,鳳鳴里,"256","135","121","2462","1218","1244","644","281","363",113Y06M
"64000",高雄市,"64000110",小港區,64000110-034,龍鳳里,"274","153","121","2528","1251","1277","597","267","330",113Y06M
"64000",高雄市,"64000110",小港區,64000110-035,鳳森里,"221","109","112","1752","858","894","455","204","251",113Y06M
"64000",高雄市,"64000110",小港區,64000110-036,鳳林里,"246","132","114","2436","1178","1258","616","266","350",113Y06M
"64000",高雄市,"64000110",小港區,64000110-037,鳳興里,"227","123","104","2088","1021","1067","434","192","242",113Y06M
"64000",高雄市,"64000110",小港區,64000110-038,鳳源里,"355","164","191","3032","1522","1510","648","293","355",113Y06M
"64000",高雄市,"64000120",鳳山區,64000120-001,縣口里,"38","17","21","238","117","121","140","72","68",113Y06M
"64000",高雄市,"64000120",鳳山區,64000120-002,成功里,"63","30","33","367","192","175","209","106","103",113Y06M
"64000",高雄市,"64000120",鳳山區,64000120-003,光明里,"142","69","73","917","473","444","354","158","196",113Y06M
"64000",高雄市,"64000120",鳳山區,64000120-004,興中里,"177","102","75","678","312","366","195","90","105",113Y06M
"64000",高雄市,"64000120",鳳山區,64000120-005,南興里,"142","77","65","579","273","306","258","125","133",113Y06M
"64000",高雄市,"64000120",鳳山區,64000120-006,和德里,"780","407","373","2482","1152","1330","438","199","239",113Y06M
"64000",高雄市,"64000120",鳳山區,64000120-007,鳳崗里,"123","67","56","713","329","384","326","146","180",113Y06M
"64000",高雄市,"64000120",鳳山區,64000120-008,中和里,"335","179","156","2347","1173","1174","897","392","505",113Y06M
"64000",高雄市,"64000120",鳳山區,64000120-009,鎮北里,"1520","783","737","9271","4435","4836","1554","698","856",113Y06M
"64000",高雄市,"64000120",鳳山區,64000120-010,縣衙里,"87","44","43","603","294","309","220","99","121",113Y06M
"64000",高雄市,"64000120",鳳山區,64000120-011,文英里,"380","202","178","2799","1404","1395","779","344","435",113Y06M
"64000",高雄市,"64000120",鳳山區,64000120-012,鎮西里,"529","270","259","3499","1749","1750","1284","586","698",113Y06M
"64000",高雄市,"64000120",鳳山區,64000120-013,鎮東里,"278","138","140","1994","1039","955","541","218","323",113Y06M
"64000",高雄市,"64000120",鳳山區,64000120-014,埤頂里,"837","439","398","4670","2377","2293","1336","553","783",113Y06M
"64000",高雄市,"64000120",鳳山區,64000120-015,中正里,"529","271","258","3168","1598","1570","1102","358","744",113Y06M
"64000",高雄市,"64000120",鳳山區,64000120-016,鎮南里,"413","208","205","3746","1896","1850","1016","457","559",113Y06M
"64000",高雄市,"64000120",鳳山區,64000120-017,老爺里,"628","318","310","5341","2677","2664","1462","652","810",113Y06M
"64000",高雄市,"64000120",鳳山區,64000120-018,瑞竹里,"865","436","429","4170","2079","2091","1217","499","718",113Y06M
"64000",高雄市,"64000120",鳳山區,64000120-019,忠義里,"432","217","215","3476","1692","1784","1017","444","573",113Y06M
"64000",高雄市,"64000120",鳳山區,64000120-020,誠義里,"309","169","140","3340","1651","1689","627","272","355",113Y06M
"64000",高雄市,"64000120",鳳山區,64000120-021,新興里,"182","116","66","2674","1713","961","836","492","344",113Y06M
"64000",高雄市,"64000120",鳳山區,64000120-022,海光里,"364","188","176","2220","1102","1118","623","249","374",113Y06M
"64000",高雄市,"64000120",鳳山區,64000120-024,忠誠里,"440","229","211","2844","1420","1424","753","325","428",113Y06M
"64000",高雄市,"64000120",鳳山區,64000120-025,新甲里,"457","239","218","2391","1160","1231","636","284","352",113Y06M
"64000",高雄市,"64000120",鳳山區,64000120-026,武漢里,"603","323","280","3722","1840","1882","1048","464","584",113Y06M
"64000",高雄市,"64000120",鳳山區,64000120-027,正義里,"595","310","285","4714","2324","2390","1411","617","794",113Y06M
"64000",高雄市,"64000120",鳳山區,64000120-028,一甲里,"233","140","93","2396","1204","1192","750","318","432",113Y06M
"64000",高雄市,"64000120",鳳山區,64000120-029,福興里,"1046","557","489","4385","2140","2245","1290","566","724",113Y06M
"64000",高雄市,"64000120",鳳山區,64000120-030,東門里,"666","354","312","4400","2101","2299","1211","470","741",113Y06M
"64000",高雄市,"64000120",鳳山區,64000120-031,瑞興里,"664","324","340","3996","1927","2069","869","339","530",113Y06M
"64000",高雄市,"64000120",鳳山區,64000120-032,天興里,"499","266","233","2563","1262","1301","788","346","442",113Y06M
"64000",高雄市,"64000120",鳳山區,64000120-033,新強里,"833","441","392","4346","2147","2199","1079","487","592",113Y06M
"64000",高雄市,"64000120",鳳山區,64000120-034,國泰里,"287","153","134","2540","1274","1266","1140","506","634",113Y06M
"64000",高雄市,"64000120",鳳山區,64000120-035,鳳東里,"1177","590","587","5596","2764","2832","1267","524","743",113Y06M
"64000",高雄市,"64000120",鳳山區,64000120-036,新富里,"583","311","272","3043","1525","1518","1021","470","551",113Y06M
"64000",高雄市,"64000120",鳳山區,64000120-037,國光里,"276","159","117","2201","1078","1123","974","449","525",113Y06M
"64000",高雄市,"64000120",鳳山區,64000120-038,國隆里,"179","80","99","1647","823","824","712","328","384",113Y06M
"64000",高雄市,"64000120",鳳山區,64000120-039,文德里,"856","440","416","7378","3466","3912","1825","806","1019",113Y06M
"64000",高雄市,"64000120",鳳山區,64000120-040,過埤里,"2859","1452","1407","13246","6645","6601","1970","888","1082",113Y06M
"64000",高雄市,"64000120",鳳山區,64000120-041,曹公里,"207","113","94","1422","662","760","498","231","267",113Y06M
"64000",高雄市,"64000120",鳳山區,64000120-042,興仁里,"505","250","255","2425","1202","1223","871","385","486",113Y06M
"64000",高雄市,"64000120",鳳山區,64000120-043,五福里,"587","297","290","2298","1131","1167","737","328","409",113Y06M
"64000",高雄市,"64000120",鳳山區,64000120-044,忠孝里,"612","316","296","4214","2090","2124","1385","577","808",113Y06M
"64000",高雄市,"64000120",鳳山區,64000120-045,生明里,"189","87","102","1602","768","834","442","186","256",113Y06M
"64000",高雄市,"64000120",鳳山區,64000120-046,和興里,"1082","590","492","3451","1664","1787","1070","485","585",113Y06M
"64000",高雄市,"64000120",鳳山區,64000120-047,協和里,"462","229","233","2359","1174","1185","721","309","412",113Y06M
"64000",高雄市,"64000120",鳳山區,64000120-048,文山里,"730","387","343","4911","2458","2453","1381","635","746",113Y06M
"64000",高雄市,"64000120",鳳山區,64000120-049,福誠里,"961","501","460","4105","1943","2162","849","381","468",113Y06M
"64000",高雄市,"64000120",鳳山區,64000120-050,誠德里,"375","192","183","2110","1020","1090","525","199","326",113Y06M
"64000",高雄市,"64000120",鳳山區,64000120-051,三民里,"168","95","73","751","355","396","315","145","170",113Y06M
"64000",高雄市,"64000120",鳳山區,64000120-053,北門里,"515","264","251","3039","1536","1503","944","406","538",113Y06M
"64000",高雄市,"64000120",鳳山區,64000120-054,富甲里,"128","75","53","1419","698","721","438","173","265",113Y06M
"64000",高雄市,"64000120",鳳山區,64000120-055,南成里,"2220","1143","1077","8320","4105","4215","1458","681","777",113Y06M
"64000",高雄市,"64000120",鳳山區,64000120-056,文華里,"1405","689","716","6579","3145","3434","1769","734","1035",113Y06M
"64000",高雄市,"64000120",鳳山區,64000120-057,大德里,"718","363","355","3602","1808","1794","925","370","555",113Y06M
"64000",高雄市,"64000120",鳳山區,64000120-058,武松里,"193","105","88","1962","1029","933","628","290","338",113Y06M
"64000",高雄市,"64000120",鳳山區,64000120-059,文衡里,"452","237","215","3454","1626","1828","697","296","401",113Y06M
"64000",高雄市,"64000120",鳳山區,64000120-060,文福里,"1808","949","859","8127","3828","4299","1559","665","894",113Y06M
"64000",高雄市,"64000120",鳳山區,64000120-061,誠信里,"190","96","94","1761","817","944","307","137","170",113Y06M
"64000",高雄市,"64000120",鳳山區,64000120-062,誠智里,"258","134","124","2161","1049","1112","551","224","327",113Y06M
"64000",高雄市,"64000120",鳳山區,64000120-063,國富里,"240","123","117","1960","944","1016","590","257","333",113Y06M
"64000",高雄市,"64000120",鳳山區,64000120-064,武慶里,"294","151","143","1762","868","894","495","196","299",113Y06M
"64000",高雄市,"64000120",鳳山區,64000120-065,海洋里,"554","262","292","2962","1411","1551","796","361","435",113Y06M
"64000",高雄市,"64000120",鳳山區,64000120-066,新武里,"369","202","167","1944","972","972","616","268","348",113Y06M
"64000",高雄市,"64000120",鳳山區,64000120-067,新樂里,"624","326","298","3582","1727","1855","774","339","435",113Y06M
"64000",高雄市,"64000120",鳳山區,64000120-068,新泰里,"689","360","329","3382","1629","1753","705","315","390",113Y06M
"64000",高雄市,"64000120",鳳山區,64000120-069,中崙里,"183","87","96","1892","925","967","510","231","279",113Y06M
"64000",高雄市,"64000120",鳳山區,64000120-070,中榮里,"321","156","165","3705","1868","1837","878","377","501",113Y06M
"64000",高雄市,"64000120",鳳山區,64000120-071,中民里,"289","156","133","3686","1835","1851","802","337","465",113Y06M
"64000",高雄市,"64000120",鳳山區,64000120-072,二甲里,"698","369","329","3667","1859","1808","988","436","552",113Y06M
"64000",高雄市,"64000120",鳳山區,64000120-073,龍成里,"216","119","97","2106","1080","1026","702","302","400",113Y06M
"64000",高雄市,"64000120",鳳山區,64000120-074,富榮里,"279","152","127","1902","942","960","451","213","238",113Y06M
"64000",高雄市,"64000120",鳳山區,64000120-075,善美里,"489","264","225","4563","2227","2336","1142","485","657",113Y06M
"64000",高雄市,"64000120",鳳山區,64000120-076,南和里,"270","126","144","1972","984","988","573","254","319",113Y06M
"64000",高雄市,"64000120",鳳山區,64000120-077,福祥里,"380","202","178","2098","1045","1053","590","252","338",113Y06M
"64000",高雄市,"64000120",鳳山區,64000120-078,保安里,"1874","949","925","6123","2937","3186","837","354","483",113Y06M
"64000",高雄市,"64000130",林園區,64000130-001,東林里,"458","247","211","2365","1177","1188","627","277","350",113Y06M
"64000",高雄市,"64000130",林園區,64000130-002,林園里,"475","239","236","2373","1159","1214","694","295","399",113Y06M
"64000",高雄市,"64000130",林園區,64000130-003,溪州里,"631","305","326","3625","1855","1770","766","354","412",113Y06M
"64000",高雄市,"64000130",林園區,64000130-004,潭頭里,"220","107","113","2201","1151","1050","550","248","302",113Y06M
"64000",高雄市,"64000130",林園區,64000130-005,中厝里,"298","164","134","2485","1318","1167","595","246","349",113Y06M
"64000",高雄市,"64000130",林園區,64000130-006,中門里,"237","124","113","2036","1053","983","538","257","281",113Y06M
"64000",高雄市,"64000130",林園區,64000130-007,頂厝里,"622","332","290","3915","1992","1923","888","378","510",113Y06M
"64000",高雄市,"64000130",林園區,64000130-008,港埔里,"159","84","75","1412","735","677","403","191","212",113Y06M
"64000",高雄市,"64000130",林園區,64000130-009,西溪里,"347","177","170","2769","1370","1399","666","339","327",113Y06M
"64000",高雄市,"64000130",林園區,64000130-010,港嘴里,"148","73","75","1353","655","698","353","173","180",113Y06M
"64000",高雄市,"64000130",林園區,64000130-011,北汕里,"122","66","56","1199","631","568","352","157","195",113Y06M
"64000",高雄市,"64000130",林園區,64000130-012,林內里,"258","150","108","1650","859","791","373","140","233",113Y06M
"64000",高雄市,"64000130",林園區,64000130-013,王公里,"571","308","263","3421","1735","1686","768","377","391",113Y06M
"64000",高雄市,"64000130",林園區,64000130-014,林家里,"138","78","60","1001","531","470","297","144","153",113Y06M
"64000",高雄市,"64000130",林園區,64000130-015,龔厝里,"232","126","106","1589","819","770","431","199","232",113Y06M
"64000",高雄市,"64000130",林園區,64000130-016,鳳芸里,"166","81","85","1386","697","689","409","186","223",113Y06M
"64000",高雄市,"64000130",林園區,64000130-017,中芸里,"165","84","81","1368","698","670","417","196","221",113Y06M
"64000",高雄市,"64000130",林園區,64000130-018,東汕里,"61","28","33","654","344","310","182","93","89",113Y06M
"64000",高雄市,"64000130",林園區,64000130-019,西汕里,"68","28","40","576","293","283","143","68","75",113Y06M
"64000",高雄市,"64000130",林園區,64000130-020,仁愛里,"442","237","205","2403","1226","1177","653","278","375",113Y06M
"64000",高雄市,"64000130",林園區,64000130-021,文賢里,"281","135","146","1970","985","985","478","199","279",113Y06M
"64000",高雄市,"64000130",林園區,64000130-022,廣應里,"517","272","245","2825","1429","1396","683","311","372",113Y06M
"64000",高雄市,"64000130",林園區,64000130-023,五福里,"488","245","243","2339","1190","1149","407","180","227",113Y06M
"64000",高雄市,"64000130",林園區,64000130-024,中汕里,"163","82","81","1750","888","862","456","197","259",113Y06M
"64000",高雄市,"64000140",大寮區,64000140-001,拷潭里,"135","65","70","1027","538","489","327","157","170",113Y06M
"64000",高雄市,"64000140",大寮區,64000140-002,內坑里,"751","401","350","5130","2676","2454","1022","492","530",113Y06M
"64000",高雄市,"64000140",大寮區,64000140-003,大寮里,"881","436","445","5733","2973","2760","1349","625","724",113Y06M
"64000",高雄市,"64000140",大寮區,64000140-004,上寮里,"310","150","160","2043","1082","961","513","256","257",113Y06M
"64000",高雄市,"64000140",大寮區,64000140-005,三隆里,"530","277","253","3717","1916","1801","1023","485","538",113Y06M
"64000",高雄市,"64000140",大寮區,64000140-006,琉球里,"593","310","283","4426","2283","2143","874","397","477",113Y06M
"64000",高雄市,"64000140",大寮區,64000140-007,翁園里,"476","246","230","3390","1784","1606","735","344","391",113Y06M
"64000",高雄市,"64000140",大寮區,64000140-008,前庄里,"172","94","78","1778","923","855","516","232","284",113Y06M
"64000",高雄市,"64000140",大寮區,64000140-009,中庄里,"1510","775","735","9048","4592","4456","2229","1004","1225",113Y06M
"64000",高雄市,"64000140",大寮區,64000140-010,後庄里,"903","459","444","6487","3289","3198","1550","674","876",113Y06M
"64000",高雄市,"64000140",大寮區,64000140-011,義仁里,"113","45","68","1359","757","602","426","200","226",113Y06M
"64000",高雄市,"64000140",大寮區,64000140-012,新厝里,"150","80","70","1303","694","609","359","165","194",113Y06M
"64000",高雄市,"64000140",大寮區,64000140-013,過溪里,"288","148","140","2121","1127","994","456","211","245",113Y06M
"64000",高雄市,"64000140",大寮區,64000140-014,潮寮里,"283","142","141","2309","1214","1095","683","338","345",113Y06M
"64000",高雄市,"64000140",大寮區,64000140-015,會結里,"170","73","97","1280","705","575","344","184","160",113Y06M
"64000",高雄市,"64000140",大寮區,64000140-016,會社里,"672","358","314","5102","2693","2409","1292","574","718",113Y06M
"64000",高雄市,"64000140",大寮區,64000140-017,山頂里,"772","399","373","6210","3148","3062","1383","559","824",113Y06M
"64000",高雄市,"64000140",大寮區,64000140-018,忠義里,"17","6","11","311","164","147","140","59","81",113Y06M
"64000",高雄市,"64000140",大寮區,64000140-019,永芳里,"811","431","380","5599","2867","2732","1388","614","774",113Y06M
"64000",高雄市,"64000140",大寮區,64000140-020,義和里,"193","111","82","1652","877","775","594","270","324",113Y06M
"64000",高雄市,"64000140",大寮區,64000140-021,溪寮里,"119","54","65","1243","672","571","365","177","188",113Y06M
"64000",高雄市,"64000140",大寮區,64000140-022,江山里,"219","108","111","1471","760","711","382","170","212",113Y06M
"64000",高雄市,"64000140",大寮區,64000140-023,昭明里,"359","184","175","3064","1628","1436","774","381","393",113Y06M
"64000",高雄市,"64000140",大寮區,64000140-025,中興里,"371","206","165","5227","2735","2492","1384","487","897",113Y06M
"64000",高雄市,"64000150",大樹區,64000150-001,竹寮里,"297","139","158","2103","1087","1016","590","286","304",113Y06M
"64000",高雄市,"64000150",大樹區,64000150-002,九曲里,"648","333","315","4538","2314","2224","923","367","556",113Y06M
"64000",高雄市,"64000150",大樹區,64000150-003,久堂里,"389","193","196","3178","1624","1554","994","420","574",113Y06M
"64000",高雄市,"64000150",大樹區,64000150-004,水安里,"210","106","104","1838","995","843","546","240","306",113Y06M
"64000",高雄市,"64000150",大樹區,64000150-005,水寮里,"192","104","88","1644","908","736","572","265","307",113Y06M
"64000",高雄市,"64000150",大樹區,64000150-006,檨腳里,"362","181","181","2668","1416","1252","824","367","457",113Y06M
"64000",高雄市,"64000150",大樹區,64000150-007,興山里,"103","54","49","792","438","354","222","105","117",113Y06M
"64000",高雄市,"64000150",大樹區,64000150-008,和山里,"54","28","26","719","396","323","256","128","128",113Y06M
"64000",高雄市,"64000150",大樹區,64000150-009,姑山里,"66","35","31","746","414","332","256","116","140",113Y06M
"64000",高雄市,"64000150",大樹區,64000150-010,大坑里,"150","77","73","1069","586","483","327","153","174",113Y06M
"64000",高雄市,"64000150",大樹區,64000150-011,井腳里,"134","76","58","1140","619","521","374","176","198",113Y06M
"64000",高雄市,"64000150",大樹區,64000150-012,小坪里,"105","61","44","975","528","447","327","163","164",113Y06M
"64000",高雄市,"64000150",大樹區,64000150-013,龍目里,"122","56","66","1321","739","582","413","204","209",113Y06M
"64000",高雄市,"64000150",大樹區,64000150-014,大樹里,"262","151","111","2005","1071","934","565","266","299",113Y06M
"64000",高雄市,"64000150",大樹區,64000150-015,三和里,"87","49","38","746","384","362","273","132","141",113Y06M
"64000",高雄市,"64000150",大樹區,64000150-016,溪埔里,"138","83","55","1065","569","496","376","194","182",113Y06M
"64000",高雄市,"64000150",大樹區,64000150-017,興田里,"106","53","53","1393","579","814","502","185","317",113Y06M
"64000",高雄市,"64000150",大樹區,64000150-018,統嶺里,"30","18","12","470","235","235","173","71","102",113Y06M
"64000",高雄市,"64000160",大社區,64000160-001,嘉誠里,"51","26","25","657","359","298","244","119","125",113Y06M
"64000",高雄市,"64000160",大社區,64000160-002,保社里,"262","133","129","2762","1463","1299","587","275","312",113Y06M
"64000",高雄市,"64000160",大社區,64000160-003,大社里,"446","231","215","3873","2016","1857","1158","517","641",113Y06M
"64000",高雄市,"64000160",大社區,64000160-004,翠屏里,"152","82","70","1266","649","617","396","180","216",113Y06M
"64000",高雄市,"64000160",大社區,64000160-005,三奶里,"259","131","128","2104","1094","1010","610","273","337",113Y06M
"64000",高雄市,"64000160",大社區,64000160-006,觀音里,"528","287","241","4311","2218","2093","1163","537","626",113Y06M
"64000",高雄市,"64000160",大社區,64000160-007,神農里,"504","263","241","4039","2032","2007","966","457","509",113Y06M
"64000",高雄市,"64000160",大社區,64000160-008,中里里,"327","177","150","2710","1418","1292","672","296","376",113Y06M
"64000",高雄市,"64000160",大社區,64000160-009,保安里,"406","212","194","2526","1281","1245","692","312","380",113Y06M
"64000",高雄市,"64000170",仁武區,64000170-001,大灣里,"532","272","260","4367","2228","2139","747","347","400",113Y06M
"64000",高雄市,"64000170",仁武區,64000170-002,灣內里,"1402","715","687","7385","3702","3683","1318","613","705",113Y06M
"64000",高雄市,"64000170",仁武區,64000170-003,考潭里,"243","124","119","1946","1040","906","709","343","366",113Y06M
"64000",高雄市,"64000170",仁武區,64000170-004,烏林里,"492","244","248","2922","1456","1466","800","378","422",113Y06M
"64000",高雄市,"64000170",仁武區,64000170-005,仁福里,"57","22","35","644","331","313","221","120","101",113Y06M
"64000",高雄市,"64000170",仁武區,64000170-006,仁武里,"685","360","325","4413","2387","2026","1209","580","629",113Y06M
"64000",高雄市,"64000170",仁武區,64000170-007,文武里,"1492","764","728","8172","4200","3972","1686","761","925",113Y06M
"64000",高雄市,"64000170",仁武區,64000170-008,竹後里,"170","91","79","1734","908","826","546","253","293",113Y06M
"64000",高雄市,"64000170",仁武區,64000170-009,八卦里,"2431","1265","1166","17968","8988","8980","2748","1181","1567",113Y06M
"64000",高雄市,"64000170",仁武區,64000170-010,高楠里,"574","293","281","2692","1280","1412","551","218","333",113Y06M
"64000",高雄市,"64000170",仁武區,64000170-011,後安里,"338","167","171","2046","1079","967","563","267","296",113Y06M
"64000",高雄市,"64000170",仁武區,64000170-012,中華里,"117","58","59","1256","697","559","361","153","208",113Y06M
"64000",高雄市,"64000170",仁武區,64000170-013,五和里,"731","391","340","4912","2495","2417","817","353","464",113Y06M
"64000",高雄市,"64000170",仁武區,64000170-014,仁和里,"560","290","270","3377","1710","1667","723","329","394",113Y06M
"64000",高雄市,"64000170",仁武區,64000170-015,赤山里,"1075","580","495","6429","3278","3151","1115","511","604",113Y06M
"64000",高雄市,"64000170",仁武區,64000170-016,仁慈里,"259","129","130","1843","917","926","533","258","275",113Y06M
"64000",高雄市,"64000180",鳥松區,64000180-001,鳥松里,"874","478","396","8391","4115","4276","2340","1143","1197",113Y06M
"64000",高雄市,"64000180",鳥松區,64000180-002,夢裡里,"441","244","197","3984","1966","2018","1206","602","604",113Y06M
"64000",高雄市,"64000180",鳥松區,64000180-003,大華里,"991","492","499","7294","3598","3696","2723","1302","1421",113Y06M
"64000",高雄市,"64000180",鳥松區,64000180-004,?埔里,"293","149","144","2633","1395","1238","868","423","445",113Y06M
"64000",高雄市,"64000180",鳥松區,64000180-005,仁美里,"578","313","265","5225","2793","2432","1592","725","867",113Y06M
"64000",高雄市,"64000180",鳥松區,64000180-006,大竹里,"54","28","26","479","259","220","186","91","95",113Y06M
"64000",高雄市,"64000180",鳥松區,64000180-007,華美里,"376","186","190","2931","1503","1428","915","402","513",113Y06M
"64000",高雄市,"64000190",岡山區,64000190-001,平安里,"108","55","53","728","370","358","344","152","192",113Y06M
"64000",高雄市,"64000190",岡山區,64000190-002,岡山里,"621","329","292","3497","1789","1708","974","458","516",113Y06M
"64000",高雄市,"64000190",岡山區,64000190-003,壽天里,"652","334","318","2503","1176","1327","762","321","441",113Y06M
"64000",高雄市,"64000190",岡山區,64000190-004,維仁里,"114","63","51","660","338","322","275","132","143",113Y06M
"64000",高雄市,"64000190",岡山區,64000190-005,後紅里,"483","239","244","3628","1741","1887","700","306","394",113Y06M
"64000",高雄市,"64000190",岡山區,64000190-006,大遼里,"159","85","74","1087","601","486","331","143","188",113Y06M
"64000",高雄市,"64000190",岡山區,64000190-007,忠孝里,"456","234","222","2047","1027","1020","802","325","477",113Y06M
"64000",高雄市,"64000190",岡山區,64000190-008,和平里,"88","36","52","370","175","195","79","34","45",113Y06M
"64000",高雄市,"64000190",岡山區,64000190-009,前峰里,"348","190","158","2248","1110","1138","631","251","380",113Y06M
"64000",高雄市,"64000190",岡山區,64000190-010,劉厝里,"146","81","65","1056","548","508","377","177","200",113Y06M
"64000",高雄市,"64000190",岡山區,64000190-011,協和里,"483","246","237","2845","1374","1471","732","329","403",113Y06M
"64000",高雄市,"64000190",岡山區,64000190-012,後協里,"680","371","309","4527","2261","2266","1159","476","683",113Y06M
"64000",高雄市,"64000190",岡山區,64000190-013,信義里,"205","103","102","1271","659","612","384","148","236",113Y06M
"64000",高雄市,"64000190",岡山區,64000190-014,潭底里,"88","42","46","611","331","280","166","76","90",113Y06M
"64000",高雄市,"64000190",岡山區,64000190-015,三和里,"90","41","49","654","346","308","216","103","113",113Y06M
"64000",高雄市,"64000190",岡山區,64000190-016,仁壽里,"330","179","151","2404","1208","1196","880","395","485",113Y06M
"64000",高雄市,"64000190",岡山區,64000190-017,碧紅里,"490","272","218","3127","1607","1520","789","360","429",113Y06M
"64000",高雄市,"64000190",岡山區,64000190-018,程香里,"522","256","266","3364","1721","1643","780","337","443",113Y06M
"64000",高雄市,"64000190",岡山區,64000190-019,竹圍里,"1499","808","691","6182","2950","3232","1038","450","588",113Y06M
"64000",高雄市,"64000190",岡山區,64000190-020,台上里,"1246","610","636","5348","2619","2729","895","364","531",113Y06M
"64000",高雄市,"64000190",岡山區,64000190-021,灣裡里,"236","122","114","1589","801","788","351","159","192",113Y06M
"64000",高雄市,"64000190",岡山區,64000190-022,白米里,"260","137","123","1837","925","912","332","148","184",113Y06M
"64000",高雄市,"64000190",岡山區,64000190-023,石潭里,"198","112","86","1500","758","742","388","184","204",113Y06M
"64000",高雄市,"64000190",岡山區,64000190-024,福興里,"117","59","58","853","445","408","247","113","134",113Y06M
"64000",高雄市,"64000190",岡山區,64000190-025,本洲里,"219","109","110","1318","670","648","357","171","186",113Y06M
"64000",高雄市,"64000190",岡山區,64000190-026,嘉興里,"336","169","167","2545","1320","1225","783","374","409",113Y06M
"64000",高雄市,"64000190",岡山區,64000190-027,嘉峰里,"171","83","88","1392","750","642","377","183","194",113Y06M
"64000",高雄市,"64000190",岡山區,64000190-028,華崗里,"184","84","100","1187","623","564","349","169","180",113Y06M
"64000",高雄市,"64000190",岡山區,64000190-029,大莊里,"167","78","89","771","405","366","221","108","113",113Y06M
"64000",高雄市,"64000190",岡山區,64000190-030,協榮里,"174","89","85","1564","799","765","514","212","302",113Y06M
"64000",高雄市,"64000190",岡山區,64000190-031,為隨里,"145","77","68","576","302","274","139","69","70",113Y06M
"64000",高雄市,"64000190",岡山區,64000190-032,壽峰里,"358","185","173","1761","873","888","514","218","296",113Y06M
"64000",高雄市,"64000190",岡山區,64000190-033,仁義里,"224","120","104","1142","558","584","696","299","397",113Y06M
"64000",高雄市,"64000200",橋頭區,64000200-001,橋頭里,"259","144","115","1624","812","812","500","225","275",113Y06M
"64000",高雄市,"64000200",橋頭區,64000200-002,橋南里,"87","54","33","713","371","342","349","162","187",113Y06M
"64000",高雄市,"64000200",橋頭區,64000200-003,仕隆里,"194","97","97","1653","831","822","629","282","347",113Y06M
"64000",高雄市,"64000200",橋頭區,64000200-004,仕豐里,"318","175","143","2110","1067","1043","619","285","334",113Y06M
"64000",高雄市,"64000200",橋頭區,64000200-005,芋寮里,"83","40","43","863","472","391","315","152","163",113Y06M
"64000",高雄市,"64000200",橋頭區,64000200-006,東林里,"241","121","120","1727","886","841","570","265","305",113Y06M
"64000",高雄市,"64000200",橋頭區,64000200-007,西林里,"124","62","62","961","518","443","403","186","217",113Y06M
"64000",高雄市,"64000200",橋頭區,64000200-008,白樹里,"502","251","251","2687","1317","1370","673","304","369",113Y06M
"64000",高雄市,"64000200",橋頭區,64000200-009,筆秀里,"153","72","81","1136","595","541","372","192","180",113Y06M
"64000",高雄市,"64000200",橋頭區,64000200-010,新莊里,"976","484","492","5688","2754","2934","707","322","385",113Y06M
"64000",高雄市,"64000200",橋頭區,64000200-011,甲北里,"316","167","149","2527","1273","1254","568","264","304",113Y06M
"64000",高雄市,"64000200",橋頭區,64000200-012,甲南里,"192","102","90","1840","983","857","616","276","340",113Y06M
"64000",高雄市,"64000200",橋頭區,64000200-013,頂鹽里,"74","36","38","1069","561","508","280","141","139",113Y06M
"64000",高雄市,"64000200",橋頭區,64000200-014,中崎里,"57","30","27","454","248","206","164","82","82",113Y06M
"64000",高雄市,"64000200",橋頭區,64000200-015,仕和里,"374","198","176","2782","1390","1392","936","429","507",113Y06M
"64000",高雄市,"64000200",橋頭區,64000200-016,德松里,"273","143","130","1232","641","591","289","136","153",113Y06M
"64000",高雄市,"64000200",橋頭區,64000200-017,三德里,"94","50","44","608","314","294","195","84","111",113Y06M
"64000",高雄市,"64000210",燕巢區,64000210-001,尖山里,"67","32","35","790","404","386","326","172","154",113Y06M
"64000",高雄市,"64000210",燕巢區,64000210-002,瓊林里,"218","114","104","1636","863","773","476","221","255",113Y06M
"64000",高雄市,"64000210",燕巢區,64000210-003,安招里,"319","162","157","2485","1335","1150","873","497","376",113Y06M
"64000",高雄市,"64000210",燕巢區,64000210-004,角宿里,"245","137","108","2202","1172","1030","560","269","291",113Y06M
"64000",高雄市,"64000210",燕巢區,64000210-005,鳳雄里,"173","89","84","1859","1014","845","609","270","339",113Y06M
"64000",高雄市,"64000210",燕巢區,64000210-006,金山里,"47","25","22","308","180","128","133","62","71",113Y06M
"64000",高雄市,"64000210",燕巢區,64000210-007,東燕里,"234","123","111","1842","961","881","515","233","282",113Y06M
"64000",高雄市,"64000210",燕巢區,64000210-008,南燕里,"400","201","199","3254","1752","1502","844","393","451",113Y06M
"64000",高雄市,"64000210",燕巢區,64000210-009,西燕里,"355","186","169","2595","1352","1243","729","326","403",113Y06M
"64000",高雄市,"64000210",燕巢區,64000210-010,橫山里,"120","64","56","1381","815","566","436","214","222",113Y06M
"64000",高雄市,"64000210",燕巢區,64000210-011,深水里,"213","107","106","1763","935","828","640","311","329",113Y06M
"64000",高雄市,"64000220",田寮區,64000220-001,鹿埔里,"20","11","9","257","156","101","91","49","42",113Y06M
"64000",高雄市,"64000220",田寮區,64000220-002,南安里,"33","22","11","619","357","262","337","191","146",113Y06M
"64000",高雄市,"64000220",田寮區,64000220-003,大同里,"11","6","5","242","139","103","107","61","46",113Y06M
"64000",高雄市,"64000220",田寮區,64000220-004,田寮里,"3","1","2","209","113","96","129","73","56",113Y06M
"64000",高雄市,"64000220",田寮區,64000220-005,七星里,"14","5","9","347","198","149","229","120","109",113Y06M
"64000",高雄市,"64000220",田寮區,64000220-006,崇德里,"71","38","33","642","348","294","259","131","128",113Y06M
"64000",高雄市,"64000220",田寮區,64000220-007,西德里,"42","17","25","507","285","222","245","128","117",113Y06M
"64000",高雄市,"64000220",田寮區,64000220-008,三和里,"15","7","8","206","125","81","116","65","51",113Y06M
"64000",高雄市,"64000220",田寮區,64000220-009,古亭里,"18","6","12","291","188","103","168","81","87",113Y06M
"64000",高雄市,"64000220",田寮區,64000220-010,新興里,"60","26","34","771","425","346","362","184","178",113Y06M
"64000",高雄市,"64000230",阿蓮區,64000230-001,石安里,"99","49","50","976","522","454","300","134","166",113Y06M
"64000",高雄市,"64000230",阿蓮區,64000230-002,中路里,"186","98","88","1482","778","704","491","235","256",113Y06M
"64000",高雄市,"64000230",阿蓮區,64000230-003,?山里,"153","75","78","925","507","418","287","136","151",113Y06M
"64000",高雄市,"64000230",阿蓮區,64000230-004,港後里,"282","142","140","1632","846","786","448","211","237",113Y06M
"64000",高雄市,"64000230",阿蓮區,64000230-005,崗山里,"66","40","26","558","277","281","209","97","112",113Y06M
"64000",高雄市,"64000230",阿蓮區,64000230-006,阿蓮里,"698","342","356","3929","1975","1954","951","427","524",113Y06M
"64000",高雄市,"64000230",阿蓮區,64000230-007,清蓮里,"322","174","148","2059","1045","1014","575","244","331",113Y06M
"64000",高雄市,"64000230",阿蓮區,64000230-008,和蓮里,"291","137","154","1841","937","904","501","224","277",113Y06M
"64000",高雄市,"64000230",阿蓮區,64000230-009,青旗里,"159","83","76","1218","615","603","332","160","172",113Y06M
"64000",高雄市,"64000230",阿蓮區,64000230-010,復安里,"143","75","68","1234","643","591","403","178","225",113Y06M
"64000",高雄市,"64000230",阿蓮區,64000230-011,玉庫里,"87","44","43","844","474","370","212","103","109",113Y06M
"64000",高雄市,"64000230",阿蓮區,64000230-012,南蓮里,"371","202","169","2342","1185","1157","665","280","385",113Y06M
"64000",高雄市,"64000240",路竹區,64000240-001,竹滬里,"436","247","189","2666","1343","1323","658","289","369",113Y06M
"64000",高雄市,"64000240",路竹區,64000240-002,頂寮里,"142","58","84","859","457","402","288","138","150",113Y06M
"64000",高雄市,"64000240",路竹區,64000240-003,新達里,"109","58","51","937","492","445","285","140","145",113Y06M
"64000",高雄市,"64000240",路竹區,64000240-004,後鄉里,"145","75","70","864","443","421","246","117","129",113Y06M
"64000",高雄市,"64000240",路竹區,64000240-005,北嶺里,"136","74","62","961","488","473","255","113","142",113Y06M
"64000",高雄市,"64000240",路竹區,64000240-006,社西里,"230","131","99","1718","889","829","517","235","282",113Y06M
"64000",高雄市,"64000240",路竹區,64000240-007,甲北里,"321","172","149","1646","853","793","486","209","277",113Y06M
"64000",高雄市,"64000240",路竹區,64000240-008,甲南里,"416","228","188","2512","1321","1191","820","390","430",113Y06M
"64000",高雄市,"64000240",路竹區,64000240-009,下坑里,"330","175","155","2055","1079","976","587","278","309",113Y06M
"64000",高雄市,"64000240",路竹區,64000240-010,竹園里,"166","98","68","1477","785","692","395","196","199",113Y06M
"64000",高雄市,"64000240",路竹區,64000240-011,竹東里,"727","378","349","2861","1441","1420","743","338","405",113Y06M
"64000",高雄市,"64000240",路竹區,64000240-012,竹西里,"422","213","209","1622","837","785","519","236","283",113Y06M
"64000",高雄市,"64000240",路竹區,64000240-013,文北里,"538","299","239","2351","1204","1147","658","295","363",113Y06M
"64000",高雄市,"64000240",路竹區,64000240-014,文南里,"405","212","193","1776","903","873","562","259","303",113Y06M
"64000",高雄市,"64000240",路竹區,64000240-015,三爺里,"68","35","33","620","320","300","209","98","111",113Y06M
"64000",高雄市,"64000240",路竹區,64000240-016,鴨寮里,"332","169","163","1584","822","762","392","181","211",113Y06M
"64000",高雄市,"64000240",路竹區,64000240-017,社東里,"175","100","75","1297","664","633","416","207","209",113Y06M
"64000",高雄市,"64000240",路竹區,64000240-018,社中里,"76","42","34","596","318","278","220","101","119",113Y06M
"64000",高雄市,"64000240",路竹區,64000240-019,竹南里,"459","240","219","1967","991","976","700","323","377",113Y06M
"64000",高雄市,"64000240",路竹區,64000240-020,社南里,"445","219","226","3743","1882","1861","930","424","506",113Y06M
"64000",高雄市,"64000250",湖內區,64000250-001,海山里,"68","37","31","793","429","364","285","135","150",113Y06M
"64000",高雄市,"64000250",湖內區,64000250-002,劉家里,"58","29","29","715","389","326","245","122","123",113Y06M
"64000",高雄市,"64000250",湖內區,64000250-003,太爺里,"92","48","44","546","305","241","225","113","112",113Y06M
"64000",高雄市,"64000250",湖內區,64000250-004,公?里,"339","170","169","1887","989","898","441","201","240",113Y06M
"64000",高雄市,"64000250",湖內區,64000250-005,葉厝里,"416","208","208","2219","1149","1070","523","236","287",113Y06M
"64000",高雄市,"64000250",湖內區,64000250-006,大湖里,"419","226","193","3146","1578","1568","750","339","411",113Y06M
"64000",高雄市,"64000250",湖內區,64000250-007,田尾里,"100","55","45","780","413","367","258","114","144",113Y06M
"64000",高雄市,"64000250",湖內區,64000250-008,湖內里,"424","219","205","3331","1717","1614","647","299","348",113Y06M
"64000",高雄市,"64000250",湖內區,64000250-009,海埔里,"159","89","70","1323","681","642","428","199","229",113Y06M
"64000",高雄市,"64000250",湖內區,64000250-010,文賢里,"113","56","57","944","480","464","295","149","146",113Y06M
"64000",高雄市,"64000250",湖內區,64000250-011,中賢里,"220","111","109","1732","926","806","489","229","260",113Y06M
"64000",高雄市,"64000250",湖內區,64000250-012,逸賢里,"114","64","50","922","504","418","239","107","132",113Y06M
"64000",高雄市,"64000250",湖內區,64000250-013,忠興里,"47","21","26","525","277","248","184","86","98",113Y06M
"64000",高雄市,"64000250",湖內區,64000250-014,湖東里,"277","134","143","2277","1130","1147","509","209","300",113Y06M
"64000",高雄市,"64000260",茄萣區,64000260-001,福德里,"74","38","36","700","374","326","226","108","118",113Y06M
"64000",高雄市,"64000260",茄萣區,64000260-002,萬福里,"65","34","31","644","348","296","215","97","118",113Y06M
"64000",高雄市,"64000260",茄萣區,64000260-003,白雲里,"176","102","74","1345","704","641","403","180","223",113Y06M
"64000",高雄市,"64000260",茄萣區,64000260-004,嘉賜里,"483","246","237","3117","1623","1494","771","330","441",113Y06M
"64000",高雄市,"64000260",茄萣區,64000260-005,嘉安里,"241","124","117","1423","734","689","350","146","204",113Y06M
"64000",高雄市,"64000260",茄萣區,64000260-006,嘉定里,"70","42","28","777","428","349","282","133","149",113Y06M
"64000",高雄市,"64000260",茄萣區,64000260-007,保定里,"251","120","131","2272","1207","1065","707","308","399",113Y06M
"64000",高雄市,"64000260",茄萣區,64000260-008,光定里,"67","47","20","649","343","306","245","115","130",113Y06M
"64000",高雄市,"64000260",茄萣區,64000260-009,大定里,"67","41","26","765","435","330","278","128","150",113Y06M
"64000",高雄市,"64000260",茄萣區,64000260-010,吉定里,"82","52","30","837","420","417","281","133","148",113Y06M
"64000",高雄市,"64000260",茄萣區,64000260-011,嘉樂里,"235","127","108","1581","807","774","487","213","274",113Y06M
"64000",高雄市,"64000260",茄萣區,64000260-012,嘉泰里,"94","44","50","816","402","414","250","115","135",113Y06M
"64000",高雄市,"64000260",茄萣區,64000260-013,嘉福里,"72","34","38","751","408","343","232","110","122",113Y06M
"64000",高雄市,"64000260",茄萣區,64000260-014,和協里,"109","59","50","850","450","400","273","131","142",113Y06M
"64000",高雄市,"64000260",茄萣區,64000260-015,崎漏里,"544","274","270","3987","2071","1916","954","436","518",113Y06M
"64000",高雄市,"64000270",永安區,64000270-001,永安里,"158","89","69","1278","631","647","390","187","203",113Y06M
"64000",高雄市,"64000270",永安區,64000270-002,永華里,"176","92","84","1482","773","709","393","183","210",113Y06M
"64000",高雄市,"64000270",永安區,64000270-003,新港里,"218","121","97","1942","957","985","487","223","264",113Y06M
"64000",高雄市,"64000270",永安區,64000270-004,鹽田里,"52","26","26","312","143","169","113","62","51",113Y06M
"64000",高雄市,"64000270",永安區,64000270-005,保寧里,"278","147","131","2259","1157","1102","423","187","236",113Y06M
"64000",高雄市,"64000270",永安區,64000270-006,維新里,"443","228","215","2806","1376","1430","640","288","352",113Y06M
"64000",高雄市,"64000280",彌陀區,64000280-001,光和里,"163","80","83","1070","548","522","222","101","121",113Y06M
"64000",高雄市,"64000280",彌陀區,64000280-002,彌靖里,"200","88","112","1443","720","723","437","182","255",113Y06M
"64000",高雄市,"64000280",彌陀區,64000280-003,彌仁里,"43","21","22","369","207","162","154","61","93",113Y06M
"64000",高雄市,"64000280",彌陀區,64000280-004,彌壽里,"65","31","34","561","278","283","204","100","104",113Y06M
"64000",高雄市,"64000280",彌陀區,64000280-005,彌陀里,"181","87","94","1343","721","622","394","164","230",113Y06M
"64000",高雄市,"64000280",彌陀區,64000280-006,舊港里,"147","78","69","1244","677","567","325","149","176",113Y06M
"64000",高雄市,"64000280",彌陀區,64000280-007,文安里,"140","80","60","1312","695","617","374","187","187",113Y06M
"64000",高雄市,"64000280",彌陀區,64000280-008,鹽埕里,"205","107","98","1593","849","744","435","219","216",113Y06M
"64000",高雄市,"64000280",彌陀區,64000280-009,過港里,"101","54","47","715","360","355","213","105","108",113Y06M
"64000",高雄市,"64000280",彌陀區,64000280-010,海尾里,"68","28","40","643","342","301","194","96","98",113Y06M
"64000",高雄市,"64000280",彌陀區,64000280-011,漯底里,"134","70","64","934","475","459","212","100","112",113Y06M
"64000",高雄市,"64000280",彌陀區,64000280-012,南寮里,"213","101","112","1709","892","817","430","193","237",113Y06M
"64000",高雄市,"64000290",梓官區,64000290-001,梓信里,"253","143","110","1688","893","795","485","235","250",113Y06M
"64000",高雄市,"64000290",梓官區,64000290-002,梓義里,"246","126","120","1713","911","802","479","227","252",113Y06M
"64000",高雄市,"64000290",梓官區,64000290-003,梓和里,"237","130","107","1651","837","814","567","242","325",113Y06M
"64000",高雄市,"64000290",梓官區,64000290-004,梓平里,"209","112","97","1190","599","591","297","140","157",113Y06M
"64000",高雄市,"64000290",梓官區,64000290-005,中崙里,"139","56","83","893","454","439","246","107","139",113Y06M
"64000",高雄市,"64000290",梓官區,64000290-006,赤崁里,"164","71","93","1457","804","653","413","190","223",113Y06M
"64000",高雄市,"64000290",梓官區,64000290-007,禮蚵里,"147","73","74","1576","853","723","487","210","277",113Y06M
"64000",高雄市,"64000290",梓官區,64000290-008,智蚵里,"240","123","117","2284","1223","1061","609","275","334",113Y06M
"64000",高雄市,"64000290",梓官區,64000290-009,信蚵里,"220","114","106","2150","1137","1013","429","195","234",113Y06M
"64000",高雄市,"64000290",梓官區,64000290-010,同安里,"126","53","73","768","409","359","231","109","122",113Y06M
"64000",高雄市,"64000290",梓官區,64000290-011,大舍里,"450","236","214","3030","1633","1397","762","318","444",113Y06M
"64000",高雄市,"64000290",梓官區,64000290-012,赤東里,"138","70","68","1707","881","826","510","245","265",113Y06M
"64000",高雄市,"64000290",梓官區,64000290-013,赤西里,"69","40","29","632","355","277","147","53","94",113Y06M
"64000",高雄市,"64000290",梓官區,64000290-014,茄苳里,"189","102","87","1787","932","855","449","197","252",113Y06M
"64000",高雄市,"64000290",梓官區,64000290-015,典寶里,"198","106","92","2491","1319","1172","594","256","338",113Y06M
"64000",高雄市,"64000300",旗山區,64000300-001,太平里,"369","184","185","1635","845","790","608","275","333",113Y06M
"64000",高雄市,"64000300",旗山區,64000300-002,大德里,"342","187","155","1673","810","863","646","279","367",113Y06M
"64000",高雄市,"64000300",旗山區,64000300-003,湄洲里,"168","81","87","1086","588","498","460","199","261",113Y06M
"64000",高雄市,"64000300",旗山區,64000300-004,圓富里,"142","75","67","1372","717","655","419","188","231",113Y06M
"64000",高雄市,"64000300",旗山區,64000300-005,中正里,"95","54","41","1065","591","474","356","172","184",113Y06M
"64000",高雄市,"64000300",旗山區,64000300-006,大林里,"75","41","34","915","526","389","375","184","191",113Y06M
"64000",高雄市,"64000300",旗山區,64000300-007,上洲里,"47","23","24","694","387","307","284","135","149",113Y06M
"64000",高雄市,"64000300",旗山區,64000300-008,新光里,"50","20","30","492","281","211","245","126","119",113Y06M
"64000",高雄市,"64000300",旗山區,64000300-009,南勝里,"106","54","52","1444","783","661","622","291","331",113Y06M
"64000",高雄市,"64000300",旗山區,64000300-010,中寮里,"1","1","0","120","69","51","60","32","28",113Y06M
"64000",高雄市,"64000300",旗山區,64000300-011,東平里,"158","86","72","1353","703","650","557","251","306",113Y06M
"64000",高雄市,"64000300",旗山區,64000300-012,東昌里,"86","38","48","698","380","318","287","132","155",113Y06M
"64000",高雄市,"64000300",旗山區,64000300-013,竹峰里,"157","84","73","1130","571","559","385","183","202",113Y06M
"64000",高雄市,"64000300",旗山區,64000300-014,瑞吉里,"277","133","144","1470","738","732","487","215","272",113Y06M
"64000",高雄市,"64000300",旗山區,64000300-015,永和里,"510","270","240","2502","1269","1233","734","322","412",113Y06M
"64000",高雄市,"64000300",旗山區,64000300-016,三協里,"260","125","135","1675","890","785","584","285","299",113Y06M
"64000",高雄市,"64000300",旗山區,64000300-017,鯤洲里,"25","12","13","455","260","195","258","132","126",113Y06M
"64000",高雄市,"64000300",旗山區,64000300-018,大山里,"57","29","28","827","457","370","395","186","209",113Y06M
"64000",高雄市,"64000300",旗山區,64000300-019,中洲里,"44","23","21","518","301","217","264","118","146",113Y06M
"64000",高雄市,"64000300",旗山區,64000300-020,南洲里,"60","31","29","833","463","370","401","195","206",113Y06M
"64000",高雄市,"64000300",旗山區,64000300-021,廣福里,"35","19","16","452","251","201","173","80","93",113Y06M
"64000",高雄市,"64000310",美濃區,64000310-001,福安里,"141","78","63","1685","885","800","822","407","415",113Y06M
"64000",高雄市,"64000310",美濃區,64000310-002,合和里,"234","113","121","1614","872","742","774","371","403",113Y06M
"64000",高雄市,"64000310",美濃區,64000310-003,祿興里,"197","114","83","1745","934","811","827","407","420",113Y06M
"64000",高雄市,"64000310",美濃區,64000310-004,中壇里,"165","80","85","1356","749","607","611","314","297",113Y06M
"64000",高雄市,"64000310",美濃區,64000310-005,德興里,"112","60","52","998","544","454","428","191","237",113Y06M
"64000",高雄市,"64000310",美濃區,64000310-006,龍山里,"129","70","59","1351","773","578","725","343","382",113Y06M
"64000",高雄市,"64000310",美濃區,64000310-007,獅山里,"182","87","95","1687","906","781","744","365","379",113Y06M
"64000",高雄市,"64000310",美濃區,64000310-008,龍肚里,"57","33","24","804","459","345","546","284","262",113Y06M
"64000",高雄市,"64000310",美濃區,64000310-009,廣德里,"65","33","32","864","485","379","416","207","209",113Y06M
"64000",高雄市,"64000310",美濃區,64000310-010,興隆里,"52","24","28","678","374","304","426","231","195",113Y06M
"64000",高雄市,"64000310",美濃區,64000310-011,中圳里,"199","105","94","1464","739","725","609","306","303",113Y06M
"64000",高雄市,"64000310",美濃區,64000310-012,東門里,"68","33","35","734","395","339","427","223","204",113Y06M
"64000",高雄市,"64000310",美濃區,64000310-013,泰安里,"169","91","78","1099","591","508","512","238","274",113Y06M
"64000",高雄市,"64000310",美濃區,64000310-014,瀰濃里,"231","122","109","1543","831","712","732","351","381",113Y06M
"64000",高雄市,"64000310",美濃區,64000310-015,清水里,"112","57","55","1201","650","551","488","239","249",113Y06M
"64000",高雄市,"64000310",美濃區,64000310-016,吉洋里,"97","52","45","1293","717","576","509","249","260",113Y06M
"64000",高雄市,"64000310",美濃區,64000310-017,吉和里,"82","48","34","961","527","434","373","190","183",113Y06M
"64000",高雄市,"64000310",美濃區,64000310-018,吉東里,"167","82","85","1238","655","583","504","248","256",113Y06M
"64000",高雄市,"64000310",美濃區,64000310-019,廣林里,"71","37","34","924","516","408","470","223","247",113Y06M
"64000",高雄市,"64000320",六龜區,64000320-001,新威里,"25","17","8","461","290","171","220","115","105",113Y06M
"64000",高雄市,"64000320",六龜區,64000320-002,新興里,"30","19","11","467","272","195","175","84","91",113Y06M
"64000",高雄市,"64000320",六龜區,64000320-003,新寮里,"18","11","7","409","224","185","198","105","93",113Y06M
"64000",高雄市,"64000320",六龜區,64000320-004,新發里,"65","34","31","641","375","266","267","133","134",113Y06M
"64000",高雄市,"64000320",六龜區,64000320-005,荖濃里,"92","45","47","965","533","432","376","182","194",113Y06M
"64000",高雄市,"64000320",六龜區,64000320-006,六龜里,"70","26","44","647","362","285","262","122","140",113Y06M
"64000",高雄市,"64000320",六龜區,64000320-007,義寶里,"100","47","53","688","361","327","295","139","156",113Y06M
"64000",高雄市,"64000320",六龜區,64000320-008,興龍里,"66","31","35","575","312","263","198","99","99",113Y06M
"64000",高雄市,"64000320",六龜區,64000320-009,中興里,"120","62","58","1052","572","480","359","178","181",113Y06M
"64000",高雄市,"64000320",六龜區,64000320-010,寶來里,"67","33","34","586","317","269","274","116","158",113Y06M
"64000",高雄市,"64000320",六龜區,64000320-011,文武里,"119","50","69","1024","619","405","363","164","199",113Y06M
"64000",高雄市,"64000320",六龜區,64000320-012,大津里,"10","6","4","222","128","94","76","36","40",113Y06M
"64000",高雄市,"64000330",甲仙區,64000330-001,東安里,"14","6","8","292","164","128","134","62","72",113Y06M
"64000",高雄市,"64000330",甲仙區,64000330-002,西安里,"85","43","42","603","307","296","259","102","157",113Y06M
"64000",高雄市,"64000330",甲仙區,64000330-003,和安里,"46","22","24","438","248","190","216","95","121",113Y06M
"64000",高雄市,"64000330",甲仙區,64000330-004,大田里,"113","58","55","1139","625","514","367","172","195",113Y06M
"64000",高雄市,"64000330",甲仙區,64000330-005,寶隆里,"35","20","15","429","243","186","182","92","90",113Y06M
"64000",高雄市,"64000330",甲仙區,64000330-006,關山里,"35","19","16","378","224","154","188","95","93",113Y06M
"64000",高雄市,"64000330",甲仙區,64000330-007,小林里,"37","21","16","383","209","174","110","62","48",113Y06M
"64000",高雄市,"64000340",杉林區,64000340-001,杉林里,"33","19","14","418","243","175","153","72","81",113Y06M
"64000",高雄市,"64000340",杉林區,64000340-002,木梓里,"31","15","16","423","255","168","224","113","111",113Y06M
"64000",高雄市,"64000340",杉林區,64000340-003,集來里,"56","39","17","833","515","318","358","181","177",113Y06M
"64000",高雄市,"64000340",杉林區,64000340-004,新庄里,"69","44","25","928","544","384","493","236","257",113Y06M
"64000",高雄市,"64000340",杉林區,64000340-005,上平里,"99","50","49","1040","598","442","467","231","236",113Y06M
"64000",高雄市,"64000340",杉林區,64000340-006,月眉里,"94","46","48","1054","612","442","476","232","244",113Y06M
"64000",高雄市,"64000340",杉林區,64000340-007,月美里,"77","37","40","832","476","356","382","201","181",113Y06M
"64000",高雄市,"64000340",杉林區,64000340-008,大愛里,"263","129","134","1622","851","771","415","207","208",113Y06M
"64000",高雄市,"64000350",內門區,64000350-001,溝坪里,"53","30","23","670","392","278","234","120","114",113Y06M
"64000",高雄市,"64000350",內門區,64000350-002,金竹里,"23","13","10","405","224","181","209","104","105",113Y06M
"64000",高雄市,"64000350",內門區,64000350-003,永富里,"75","31","44","686","389","297","259","116","143",113Y06M
"64000",高雄市,"64000350",內門區,64000350-004,永吉里,"11","6","5","279","165","114","131","65","66",113Y06M
"64000",高雄市,"64000350",內門區,64000350-005,永興里,"20","8","12","267","158","109","107","47","60",113Y06M
"64000",高雄市,"64000350",內門區,64000350-006,石坑里,"30","12","18","348","185","163","134","68","66",113Y06M
"64000",高雄市,"64000350",內門區,64000350-007,內門里,"65","34","31","674","363","311","249","120","129",113Y06M
"64000",高雄市,"64000350",內門區,64000350-008,內豊里,"86","42","44","875","452","423","287","142","145",113Y06M
"64000",高雄市,"64000350",內門區,64000350-009,觀亭里,"100","53","47","1140","616","524","485","233","252",113Y06M
"64000",高雄市,"64000350",內門區,64000350-010,中埔里,"25","12","13","365","200","165","158","81","77",113Y06M
"64000",高雄市,"64000350",內門區,64000350-011,內東里,"54","32","22","522","292","230","218","121","97",113Y06M
"64000",高雄市,"64000350",內門區,64000350-012,內南里,"17","7","10","276","158","118","110","61","49",113Y06M
"64000",高雄市,"64000350",內門區,64000350-013,東埔里,"19","11","8","334","184","150","130","75","55",113Y06M
"64000",高雄市,"64000350",內門區,64000350-014,三平里,"52","29","23","477","269","208","149","79","70",113Y06M
"64000",高雄市,"64000350",內門區,64000350-015,木柵里,"28","14","14","401","247","154","158","83","75",113Y06M
"64000",高雄市,"64000350",內門區,64000350-016,內興里,"34","16","18","433","247","186","151","78","73",113Y06M
"64000",高雄市,"64000350",內門區,64000350-017,瑞山里,"15","5","10","200","121","79","103","45","58",113Y06M
"64000",高雄市,"64000350",內門區,64000350-018,光興里,"44","25","19","465","240","225","166","87","79",113Y06M
"64000",高雄市,"64000360",茂林區,64000360-001,茂林里,"108","64","44","664","336","328","92","42","50",113Y06M
"64000",高雄市,"64000360",茂林區,64000360-002,萬山里,"32","12","20","306","153","153","57","21","36",113Y06M
"64000",高雄市,"64000360",茂林區,64000360-003,多納里,"101","48","53","458","214","244","61","33","28",113Y06M
"64000",高雄市,"64000370",桃源區,64000370-001,桃源里,"140","66","74","709","382","327","94","41","53",113Y06M
"64000",高雄市,"64000370",桃源區,64000370-002,寶山里,"55","34","21","360","187","173","82","41","41",113Y06M
"64000",高雄市,"64000370",桃源區,64000370-003,建山里,"106","63","43","552","273","279","78","38","40",113Y06M
"64000",高雄市,"64000370",桃源區,64000370-004,高中里,"129","64","65","605","308","297","88","39","49",113Y06M
"64000",高雄市,"64000370",桃源區,64000370-005,勤和里,"53","30","23","193","103","90","24","12","12",113Y06M
"64000",高雄市,"64000370",桃源區,64000370-006,復興里,"42","16","26","271","143","128","28","13","15",113Y06M
"64000",高雄市,"64000370",桃源區,64000370-007,拉芙蘭里,"39","23","16","224","119","105","31","19","12",113Y06M
"64000",高雄市,"64000370",桃源區,64000370-008,梅山里,"39","18","21","236","137","99","29","16","13",113Y06M
"64000",高雄市,"64000380",那瑪夏區,64000380-001,達卡努瓦里,"303","142","161","1274","678","596","157","71","86",113Y06M
"64000",高雄市,"64000380",那瑪夏區,64000380-002,瑪雅里,"145","76","69","583","301","282","81","30","51",113Y06M
"64000",高雄市,"64000380",那瑪夏區,64000380-003,南沙魯里,"109","61","48","403","204","199","101","49","52",113Y06M
